"SID","round","newround.time","choice.time","buttonpress.time","reveal.time","self.payoff","other.payoff","self.foregone","other.foregone","ineq","side.chosen","RT","choose.var","self.var.payoff","other.var.payoff","diff.var.payoff","var.ineq.advant","var.ineq.disadvant"
"DG_s01",1,-0.734,0,1.188,1.188,10,10,10,18,0,76,1.188,0,10,18,8,8,0
"DG_s01",2,2.188,2.922,3.782,3.797,12,12,10,10,0,76,0.86,1,12,12,0,0,0
"DG_s01",3,4.797,5.532,6.282,6.282,10,10,8,8,0,76,0.75,0,8,8,0,0,0
"DG_s01",4,7.282,8.016,8.75,8.766,28,4,10,10,24,76,0.734,1,28,4,24,0,-24
"DG_s01",5,9.766,10.5,11.266,11.266,22,6,10,10,16,82,0.766,1,22,6,16,0,-16
"DG_s01",6,12.266,13,13.532,13.532,30,15,10,10,15,76,0.532,1,30,15,15,0,-15
"DG_s01",7,14.532,15.266,15.844,15.844,28,4,10,10,24,76,0.578,1,28,4,24,0,-24
"DG_s01",8,16.844,17.578,18.313,18.313,10,10,4,4,0,76,0.735,0,4,4,0,0,0
"DG_s01",9,19.313,20.047,20.969,20.969,13,7,10,10,6,76,0.922,1,13,7,6,0,-6
"DG_s01",10,21.985,22.719,23.485,23.485,10,10,10,26,0,76,0.766,0,10,26,16,16,0
"DG_s01",11,24.485,25.219,25.86,25.86,10,10,13,22,0,76,0.641,0,13,22,9,9,0
"DG_s01",12,26.86,27.594,28.282,28.282,16,4,10,10,12,76,0.688,1,16,4,12,0,-12
"DG_s01",13,29.297,30.032,30.75,30.766,10,10,8,11,0,76,0.718,0,8,11,3,3,0
"DG_s01",14,31.766,32.5,33.282,33.282,18,18,10,10,0,76,0.782,1,18,18,0,0,0
"DG_s01",15,34.282,35.016,35.891,35.891,10,10,8,16,0,82,0.875,0,8,16,8,8,0
"DG_s01",16,36.891,37.625,38.219,38.219,10,10,3,17,0,76,0.594,0,3,17,14,14,0
"DG_s01",17,39.219,39.953,40.594,40.594,10,10,6,6,0,76,0.641,0,6,6,0,0,0
"DG_s01",18,41.594,42.328,42.953,42.953,10,10,14,26,0,76,0.625,0,14,26,12,12,0
"DG_s01",19,43.969,44.703,45.391,45.407,11,7,10,10,4,76,0.688,1,11,7,4,0,-4
"DG_s01",20,46.407,47.141,47.782,47.797,16,4,10,10,12,76,0.641,1,16,4,12,0,-12
"DG_s01",21,48.797,49.532,50.25,50.25,10,10,13,1,0,76,0.718,0,13,1,12,0,-12
"DG_s01",22,51.266,52,52.938,52.938,11,7,10,10,4,76,0.938,1,11,7,4,0,-4
"DG_s01",23,53.953,54.688,55.547,55.547,10,10,6,11,0,82,0.859,0,6,11,5,5,0
"DG_s01",24,56.547,57.282,57.969,57.969,15,30,10,10,15,76,0.687,1,15,30,15,15,0
"DG_s01",25,58.969,59.703,60.547,60.547,18,10,10,10,8,76,0.844,1,18,10,8,0,-8
"DG_s01",26,61.547,62.282,63.188,63.188,10,10,6,14,0,76,0.906,0,6,14,8,8,0
"DG_s01",27,64.188,64.922,65.844,65.844,10,10,10,22,0,76,0.922,0,10,22,12,12,0
"DG_s01",28,66.844,67.578,68.641,68.641,30,10,10,10,20,82,1.063,1,30,10,20,0,-20
"DG_s01",29,69.641,70.375,71.125,71.125,18,12,10,10,6,76,0.75,1,18,12,6,0,-6
"DG_s01",30,72.125,72.86,73.516,73.516,18,10,10,10,8,76,0.656,1,18,10,8,0,-8
"DG_s01",31,74.516,75.25,75.891,75.891,10,10,13,1,0,76,0.641,0,13,1,12,0,-12
"DG_s01",32,76.891,77.625,78.438,78.453,16,8,10,10,8,76,0.813,1,16,8,8,0,-8
"DG_s01",33,79.453,80.188,80.938,80.938,26,10,10,10,16,76,0.75,1,26,10,16,0,-16
"DG_s01",34,81.938,82.672,83.313,83.313,22,13,10,10,9,82,0.641,1,22,13,9,0,-9
"DG_s01",35,84.328,85.063,85.922,85.922,10,10,8,16,0,76,0.859,0,8,16,8,8,0
"DG_s01",36,86.938,87.672,88.578,88.578,12,18,10,10,6,76,0.906,1,12,18,6,6,0
"DG_s01",37,89.594,90.328,91.188,91.188,12,4,10,10,8,76,0.86,1,12,4,8,0,-8
"DG_s01",38,92.188,92.922,93.969,93.969,14,26,10,10,12,76,1.047,1,14,26,12,12,0
"DG_s01",39,94.985,95.719,96.625,96.625,10,10,10,30,0,76,0.906,0,10,30,20,20,0
"DG_s01",40,97.641,98.375,99.641,99.641,10,10,14,14,0,76,1.266,0,14,14,0,0,0
"DG_s01",41,100.641,101.375,102.422,102.438,10,10,6,14,0,76,1.047,0,6,14,8,8,0
"DG_s01",42,103.438,104.172,105.203,105.203,10,10,6,11,0,76,1.031,0,6,11,5,5,0
"DG_s01",43,106.203,106.938,107.797,107.797,30,15,10,10,15,76,0.859,1,30,15,15,0,-15
"DG_s01",44,108.797,109.532,110.578,110.578,10,10,3,17,0,76,1.046,0,3,17,14,14,0
"DG_s01",45,111.594,112.328,113.141,113.141,13,7,10,10,6,76,0.813,1,13,7,6,0,-6
"DG_s01",46,114.141,114.875,115.735,115.75,10,10,12,18,0,76,0.86,0,12,18,6,6,0
"DG_s01",47,116.75,117.485,118.282,118.282,16,8,10,10,8,76,0.797,1,16,8,8,0,-8
"DG_s01",48,119.282,120.016,120.86,120.86,10,10,10,30,0,76,0.844,0,10,30,20,20,0
"DG_s01",49,121.86,122.594,123.282,123.282,18,12,10,10,6,76,0.688,1,18,12,6,0,-6
"DG_s01",50,124.282,125.016,125.719,125.719,10,10,2,2,0,76,0.703,0,2,2,0,0,0
"DG_s01",51,126.719,127.453,127.953,127.953,10,10,3,31,0,76,0.5,0,3,31,28,28,0
"DG_s01",52,128.969,129.703,130.828,130.828,10,22,10,10,12,76,1.125,1,10,22,12,12,0
"DG_s01",53,131.828,132.563,133.266,133.266,26,10,10,10,16,82,0.703,1,26,10,16,0,-16
"DG_s01",54,134.282,135.016,135.61,135.61,30,10,10,10,20,76,0.594,1,30,10,20,0,-20
"DG_s01",55,136.625,137.36,138.219,138.219,10,10,6,22,0,82,0.859,0,6,22,16,16,0
"DG_s01",56,139.219,139.953,140.938,140.938,10,10,10,18,0,76,0.985,0,10,18,8,8,0
"DG_s01",57,141.938,142.672,143.907,143.907,13,22,10,10,9,76,1.235,1,13,22,9,9,0
"DG_s01",58,144.907,145.641,146.407,146.422,10,10,3,31,0,76,0.766,0,3,31,28,28,0
"DG_s01",59,147.422,148.157,148.891,148.891,26,14,10,10,12,82,0.734,1,26,14,12,0,-12
"DG_s01",60,149.891,150.625,151.547,151.547,18,2,10,10,16,82,0.922,1,18,2,16,0,-16
"DG_s01",61,152.547,153.282,154.032,154.032,16,16,10,10,0,76,0.75,1,16,16,0,0,0
"DG_s01",62,155.032,155.766,156.547,156.547,10,10,8,11,0,76,0.781,0,8,11,3,3,0
"DG_s01",63,157.547,158.282,159.219,159.219,10,10,10,26,0,76,0.937,0,10,26,16,16,0
"DG_s01",64,160.219,160.953,162.063,162.078,15,30,10,10,15,76,1.11,1,15,30,15,15,0
"DG_s01",65,163.078,163.813,164.657,164.672,22,10,10,10,12,76,0.844,1,22,10,12,0,-12
"DG_s01",66,165.672,166.407,167.328,167.344,12,4,10,10,8,76,0.921,1,12,4,8,0,-8
"DG_s01",67,168.344,169.078,169.782,169.782,26,14,10,10,12,82,0.704,1,26,14,12,0,-12
"DG_s01",68,170.782,171.516,172.219,172.219,22,6,10,10,16,76,0.703,1,22,6,16,0,-16
"DG_s01",69,173.219,173.953,175,175.016,10,10,6,22,0,82,1.047,0,6,22,16,16,0
"DG_s01",70,176.016,176.75,177.532,177.532,10,10,8,12,0,76,0.782,0,8,12,4,4,0
"DG_s01",71,178.532,179.266,180.078,180.078,10,10,3,12,0,82,0.812,0,3,12,9,9,0
"DG_s01",72,181.078,181.813,182.344,182.344,18,2,10,10,16,76,0.531,1,18,2,16,0,-16
"DG_s01",73,183.344,184.078,184.719,184.719,22,10,10,10,12,82,0.641,1,22,10,12,0,-12
"DG_s01",74,185.719,186.453,187,187.016,22,13,10,10,9,76,0.547,1,22,13,9,0,-9
"DG_s01",75,188.016,188.75,189.672,189.688,10,10,8,12,0,76,0.922,0,8,12,4,4,0
"DG_s01",76,190.688,191.422,192.25,192.25,10,10,3,12,0,76,0.828,0,3,12,9,9,0
"DG_s01",77,193.266,194,194.657,194.657,10,10,10,18,0,76,0.657,0,10,18,8,8,0
"DG_s01",78,195.657,196.391,197.141,197.157,12,12,10,10,0,76,0.75,1,12,12,0,0,0
"DG_s01",79,198.157,198.891,199.578,199.578,10,10,8,8,0,76,0.687,0,8,8,0,0,0
"DG_s01",80,200.578,201.313,201.922,201.922,28,4,10,10,24,76,0.609,1,28,4,24,0,-24
"DG_s01",81,202.938,203.672,204.328,204.328,22,6,10,10,16,82,0.656,1,22,6,16,0,-16
"DG_s01",82,205.344,206.078,206.594,206.594,30,15,10,10,15,76,0.516,1,30,15,15,0,-15
"DG_s01",83,207.594,208.328,208.969,208.969,28,4,10,10,24,76,0.641,1,28,4,24,0,-24
"DG_s01",84,209.969,210.703,211.469,211.485,10,10,4,4,0,76,0.766,0,4,4,0,0,0
"DG_s01",85,212.485,213.219,214,214,13,7,10,10,6,76,0.781,1,13,7,6,0,-6
"DG_s01",86,215,215.735,216.422,216.422,10,10,10,26,0,76,0.687,0,10,26,16,16,0
"DG_s01",87,217.422,218.157,219.375,219.391,10,10,13,22,0,76,1.218,0,13,22,9,9,0
"DG_s01",88,220.391,221.125,221.985,221.985,16,4,10,10,12,76,0.86,1,16,4,12,0,-12
"DG_s01",89,222.985,223.719,224.969,224.969,10,10,8,11,0,76,1.25,0,8,11,3,3,0
"DG_s01",90,225.969,226.703,228,228,18,18,10,10,0,76,1.297,1,18,18,0,0,0
"DG_s01",91,229,229.735,230.672,230.688,10,10,8,16,0,82,0.937,0,8,16,8,8,0
"DG_s01",92,231.688,232.422,233.625,233.625,10,10,3,17,0,76,1.203,0,3,17,14,14,0
"DG_s01",93,234.625,235.36,236.078,236.094,10,10,6,6,0,76,0.718,0,6,6,0,0,0
"DG_s01",94,237.094,237.828,238.813,238.813,10,10,14,26,0,76,0.985,0,14,26,12,12,0
"DG_s01",95,239.813,240.547,241.547,241.547,11,7,10,10,4,76,1,1,11,7,4,0,-4
"DG_s01",96,242.547,243.282,243.922,243.922,16,4,10,10,12,76,0.64,1,16,4,12,0,-12
"DG_s01",97,244.922,245.657,246.391,246.391,10,10,13,1,0,76,0.734,0,13,1,12,0,-12
"DG_s01",98,247.391,248.125,249.016,249.016,11,7,10,10,4,76,0.891,1,11,7,4,0,-4
"DG_s01",99,250.016,250.75,251.61,251.61,10,10,6,11,0,82,0.86,0,6,11,5,5,0
"DG_s01",100,252.61,253.344,254.407,254.407,10,10,15,30,0,82,1.063,0,15,30,15,15,0
"DG_s01",101,255.407,256.141,256.875,256.875,18,10,10,10,8,76,0.734,1,18,10,8,0,-8
"DG_s01",102,257.875,258.61,259.438,259.453,10,10,6,14,0,76,0.828,0,6,14,8,8,0
"DG_s01",103,260.453,261.188,262,262.016,10,10,10,22,0,76,0.812,0,10,22,12,12,0
"DG_s01",104,263.016,263.75,264.485,264.485,30,10,10,10,20,82,0.735,1,30,10,20,0,-20
"DG_s01",105,265.485,266.219,266.844,266.844,18,12,10,10,6,76,0.625,1,18,12,6,0,-6
"DG_s01",106,267.844,268.578,269.266,269.266,18,10,10,10,8,76,0.688,1,18,10,8,0,-8
"DG_s01",107,270.266,271,272.078,272.078,13,1,10,10,12,82,1.078,1,13,1,12,0,-12
"DG_s01",108,273.078,273.813,274.563,274.563,16,8,10,10,8,76,0.75,1,16,8,8,0,-8
"DG_s01",109,275.563,276.297,277.141,277.141,26,10,10,10,16,76,0.844,1,26,10,16,0,-16
"DG_s01",110,278.141,278.875,279.594,279.594,22,13,10,10,9,82,0.719,1,22,13,9,0,-9
"DG_s01",111,280.61,281.344,282.203,282.203,10,10,8,16,0,76,0.859,0,8,16,8,8,0
"DG_s01",112,283.203,283.938,285.047,285.047,10,10,12,18,0,82,1.109,0,12,18,6,6,0
"DG_s01",113,286.047,286.782,287.672,287.688,12,4,10,10,8,76,0.89,1,12,4,8,0,-8
"DG_s01",114,288.688,289.422,290.219,290.219,10,10,14,26,0,82,0.797,0,14,26,12,12,0
"DG_s01",115,291.219,291.953,293.11,293.125,10,10,10,30,0,76,1.157,0,10,30,20,20,0
"DG_s01",116,294.125,294.86,295.844,295.844,10,10,14,14,0,76,0.984,0,14,14,0,0,0
"DG_s01",117,296.844,297.578,298.344,298.344,10,10,6,14,0,76,0.766,0,6,14,8,8,0
"DG_s01",118,299.344,300.078,300.985,300.985,10,10,6,11,0,76,0.907,0,6,11,5,5,0
"DG_s01",119,301.985,302.719,303.485,303.485,30,15,10,10,15,76,0.766,1,30,15,15,0,-15
"DG_s01",120,304.485,305.219,306.235,306.235,10,10,3,17,0,76,1.016,0,3,17,14,14,0
"DG_s01",121,307.235,307.969,308.985,309,13,7,10,10,6,76,1.016,1,13,7,6,0,-6
"DG_s01",122,310,310.735,311.532,311.532,10,10,12,18,0,76,0.797,0,12,18,6,6,0
"DG_s01",123,312.532,313.266,313.907,313.907,16,8,10,10,8,76,0.641,1,16,8,8,0,-8
"DG_s01",124,314.907,315.641,316.782,316.797,10,10,10,30,0,76,1.141,0,10,30,20,20,0
"DG_s01",125,317.797,318.532,319.297,319.297,18,12,10,10,6,76,0.765,1,18,12,6,0,-6
"DG_s01",126,320.297,321.032,321.938,321.938,10,10,2,2,0,76,0.906,0,2,2,0,0,0
"DG_s01",127,322.938,323.672,324.735,324.75,10,10,3,31,0,76,1.063,0,3,31,28,28,0
"DG_s01",128,325.75,326.485,327.578,327.578,10,10,10,22,0,82,1.093,0,10,22,12,12,0
"DG_s01",129,328.578,329.313,330.313,330.313,26,10,10,10,16,82,1,1,26,10,16,0,-16
"DG_s01",130,331.313,332.047,332.641,332.641,30,10,10,10,20,76,0.594,1,30,10,20,0,-20
"DG_s01",131,333.641,334.375,335.313,335.313,10,10,6,22,0,82,0.938,0,6,22,16,16,0
"DG_s01",132,336.313,337.047,338.157,338.157,10,10,10,18,0,76,1.11,0,10,18,8,8,0
"DG_s01",133,339.157,339.891,340.953,340.953,10,10,13,22,0,82,1.062,0,13,22,9,9,0
"DG_s01",134,341.953,342.688,343.344,343.344,10,10,3,31,0,76,0.656,0,3,31,28,28,0
"DG_s01",135,344.344,345.078,345.813,345.828,26,14,10,10,12,82,0.735,1,26,14,12,0,-12
"DG_s01",136,346.828,347.563,348.453,348.453,18,2,10,10,16,82,0.89,1,18,2,16,0,-16
"DG_s01",137,349.453,350.188,351.063,351.063,16,16,10,10,0,76,0.875,1,16,16,0,0,0
"DG_s01",138,352.063,352.797,353.516,353.516,10,10,8,11,0,76,0.719,0,8,11,3,3,0
"DG_s01",139,354.516,355.25,356.047,356.063,10,10,10,26,0,76,0.797,0,10,26,16,16,0
"DG_s01",140,357.063,357.797,359.063,359.063,10,10,15,30,0,82,1.266,0,15,30,15,15,0
"DG_s01",141,360.063,360.797,361.391,361.407,22,10,10,10,12,76,0.594,1,22,10,12,0,-12
"DG_s01",142,362.407,363.141,363.922,363.922,12,4,10,10,8,76,0.781,1,12,4,8,0,-8
"DG_s01",143,364.922,365.657,366.328,366.328,26,14,10,10,12,82,0.671,1,26,14,12,0,-12
"DG_s01",144,367.328,368.063,368.735,368.75,22,6,10,10,16,76,0.672,1,22,6,16,0,-16
"DG_s01",145,369.75,370.485,371.625,371.625,10,10,6,22,0,82,1.14,0,6,22,16,16,0
"DG_s01",146,372.641,373.375,374.016,374.016,10,10,8,12,0,76,0.641,0,8,12,4,4,0
"DG_s01",147,375.016,375.75,376.5,376.5,10,10,3,12,0,82,0.75,0,3,12,9,9,0
"DG_s01",148,377.5,378.235,378.969,378.969,18,2,10,10,16,76,0.734,1,18,2,16,0,-16
"DG_s01",149,379.969,380.703,381.375,381.391,22,10,10,10,12,82,0.672,1,22,10,12,0,-12
"DG_s01",150,382.391,383.125,383.672,383.688,22,13,10,10,9,76,0.547,1,22,13,9,0,-9
"DG_s01",151,384.688,385.422,386.25,386.25,10,10,8,12,0,76,0.828,0,8,12,4,4,0
"DG_s01",152,387.25,387.985,388.61,388.61,10,10,3,12,0,76,0.625,0,3,12,9,9,0
"DG_s01",153,389.61,390.344,391.36,391.36,10,10,10,18,0,76,1.016,0,10,18,8,8,0
"DG_s01",154,392.36,393.094,394.328,394.328,12,12,10,10,0,76,1.234,1,12,12,0,0,0
"DG_s01",155,395.328,396.063,396.922,396.922,10,10,8,8,0,76,0.859,0,8,8,0,0,0
"DG_s01",156,397.922,398.657,399.375,399.391,28,4,10,10,24,76,0.718,1,28,4,24,0,-24
"DG_s01",157,400.391,401.125,402.063,402.078,22,6,10,10,16,82,0.938,1,22,6,16,0,-16
"DG_s01",158,403.078,403.813,404.313,404.313,30,15,10,10,15,76,0.5,1,30,15,15,0,-15
"DG_s01",159,405.328,406.063,406.672,406.688,28,4,10,10,24,76,0.609,1,28,4,24,0,-24
"DG_s01",160,407.688,408.422,409.313,409.313,10,10,4,4,0,76,0.891,0,4,4,0,0,0
"DG_s01",161,410.313,411.047,411.813,411.813,13,7,10,10,6,76,0.766,1,13,7,6,0,-6
"DG_s01",162,412.813,413.547,414.407,414.422,10,10,10,26,0,76,0.86,0,10,26,16,16,0
"DG_s01",163,415.422,416.157,417.141,417.141,10,10,13,22,0,76,0.984,0,13,22,9,9,0
"DG_s01",164,418.141,418.875,419.485,419.485,16,4,10,10,12,76,0.61,1,16,4,12,0,-12
"DG_s01",165,420.485,421.219,421.938,421.938,10,10,8,11,0,76,0.719,0,8,11,3,3,0
"DG_s01",166,422.938,423.672,424.157,424.157,18,18,10,10,0,76,0.485,1,18,18,0,0,0
"DG_s01",167,425.157,425.891,426.813,426.828,10,10,8,16,0,82,0.922,0,8,16,8,8,0
"DG_s01",168,427.828,428.563,429.219,429.219,10,10,3,17,0,76,0.656,0,3,17,14,14,0
"DG_s01",169,430.219,430.953,431.547,431.547,10,10,6,6,0,76,0.594,0,6,6,0,0,0
"DG_s01",170,432.547,433.282,434.203,434.203,10,10,14,26,0,76,0.921,0,14,26,12,12,0
"DG_s01",171,435.203,435.938,436.86,436.86,11,7,10,10,4,76,0.922,1,11,7,4,0,-4
"DG_s01",172,437.86,438.594,439.25,439.25,16,4,10,10,12,76,0.656,1,16,4,12,0,-12
"DG_s01",173,440.266,441,441.75,441.75,10,10,13,1,0,76,0.75,0,13,1,12,0,-12
"DG_s01",174,442.75,443.485,444.391,444.391,11,7,10,10,4,76,0.906,1,11,7,4,0,-4
"DG_s01",175,445.391,446.125,446.86,446.86,10,10,6,11,0,82,0.735,0,6,11,5,5,0
"DG_s01",176,447.86,448.594,449.766,449.766,15,30,10,10,15,76,1.172,1,15,30,15,15,0
"DG_s01",177,450.766,451.5,452.282,452.282,18,10,10,10,8,76,0.782,1,18,10,8,0,-8
"DG_s01",178,453.282,454.016,454.86,454.86,10,10,6,14,0,76,0.844,0,6,14,8,8,0
"DG_s01",179,455.86,456.594,457.532,457.532,10,10,10,22,0,76,0.938,0,10,22,12,12,0
"DG_s01",180,458.532,459.266,460.047,460.047,30,10,10,10,20,82,0.781,1,30,10,20,0,-20
"DG_s01",181,461.047,461.782,462.375,462.375,18,12,10,10,6,76,0.593,1,18,12,6,0,-6
"DG_s01",182,463.375,464.11,464.766,464.766,18,10,10,10,8,76,0.656,1,18,10,8,0,-8
"DG_s01",183,465.766,466.5,467.547,467.547,13,1,10,10,12,82,1.047,1,13,1,12,0,-12
"DG_s01",184,468.547,469.282,470.094,470.094,16,8,10,10,8,76,0.812,1,16,8,8,0,-8
"DG_s01",185,471.094,471.828,472.563,472.563,26,10,10,10,16,76,0.735,1,26,10,16,0,-16
"DG_s01",186,473.563,474.297,474.953,474.953,22,13,10,10,9,82,0.656,1,22,13,9,0,-9
"DG_s01",187,475.953,476.688,477.61,477.61,10,10,8,16,0,76,0.922,0,8,16,8,8,0
"DG_s01",188,478.625,479.36,480.782,480.797,10,10,12,18,0,82,1.422,0,12,18,6,6,0
"DG_s01",189,481.797,482.532,483.469,483.469,12,4,10,10,8,76,0.937,1,12,4,8,0,-8
"DG_s01",190,484.469,485.203,486.266,486.266,10,10,14,26,0,82,1.063,0,14,26,12,12,0
"DG_s01",191,487.282,488.016,488.797,488.813,10,10,10,30,0,76,0.781,0,10,30,20,20,0
"DG_s01",192,489.813,490.547,491.516,491.516,10,10,14,14,0,76,0.969,0,14,14,0,0,0
"DG_s01",193,492.516,493.25,494.25,494.25,10,10,6,14,0,76,1,0,6,14,8,8,0
"DG_s01",194,495.266,496,496.719,496.735,10,10,6,11,0,76,0.719,0,6,11,5,5,0
"DG_s01",195,497.735,498.469,499.469,499.485,30,15,10,10,15,76,1,1,30,15,15,0,-15
"DG_s01",196,500.485,501.219,502.188,502.188,10,10,3,17,0,76,0.969,0,3,17,14,14,0
"DG_s01",197,503.188,503.922,504.641,504.641,13,7,10,10,6,76,0.719,1,13,7,6,0,-6
"DG_s01",198,505.657,506.391,507.391,507.391,12,18,10,10,6,82,1,1,12,18,6,6,0
"DG_s01",199,508.391,509.125,509.719,509.719,16,8,10,10,8,76,0.594,1,16,8,8,0,-8
"DG_s01",200,510.719,511.453,512.532,512.532,10,10,10,30,0,76,1.079,0,10,30,20,20,0
"DG_s02",1,10.445,11.07,12.258,12.273,10,10,10,18,0,76,1.188,0,10,18,8,8,0
"DG_s02",2,13.273,13.898,15.398,15.414,12,12,10,10,0,76,1.5,1,12,12,0,0,0
"DG_s02",3,16.414,17.039,18.367,18.367,10,10,8,8,0,76,1.328,0,8,8,0,0,0
"DG_s02",5,23.008,23.633,24.961,24.976,22,6,10,10,16,82,1.328,1,22,6,16,0,-16
"DG_s02",7,29.617,30.242,30.961,30.976,28,4,10,10,24,76,0.719,1,28,4,24,0,-24
"DG_s02",8,31.976,32.601,33.43,33.43,10,10,4,4,0,76,0.829,0,4,4,0,0,0
"DG_s02",9,34.43,35.055,36.039,36.055,13,7,10,10,6,76,0.984,1,13,7,6,0,-6
"DG_s02",10,37.055,37.68,39.336,39.336,10,26,10,10,16,82,1.656,1,10,26,16,16,0
"DG_s02",11,40.336,40.961,42.601,42.601,13,22,10,10,9,82,1.64,1,13,22,9,9,0
"DG_s02",12,43.601,44.226,45.383,45.398,10,10,16,4,0,82,1.157,0,16,4,12,0,-12
"DG_s02",13,46.398,47.023,48.195,48.211,10,10,8,11,0,76,1.172,0,8,11,3,3,0
"DG_s02",14,49.211,49.836,51.055,51.055,18,18,10,10,0,76,1.219,1,18,18,0,0,0
"DG_s02",16,55.711,56.336,58.289,58.305,10,10,3,17,0,76,1.953,0,3,17,14,14,0
"DG_s02",17,59.305,59.93,60.664,60.664,10,10,6,6,0,76,0.734,0,6,6,0,0,0
"DG_s02",18,61.664,62.289,63.961,63.976,14,26,10,10,12,82,1.672,1,14,26,12,12,0
"DG_s02",19,64.976,65.601,67.586,67.586,11,7,10,10,4,76,1.985,1,11,7,4,0,-4
"DG_s02",20,68.586,69.211,70.273,70.273,16,4,10,10,12,76,1.062,1,16,4,12,0,-12
"DG_s02",21,71.289,71.914,73.383,73.398,13,1,10,10,12,82,1.469,1,13,1,12,0,-12
"DG_s02",22,74.398,75.023,76.086,76.086,11,7,10,10,4,76,1.063,1,11,7,4,0,-4
"DG_s02",23,77.086,77.711,79.148,79.164,6,11,10,10,5,76,1.437,1,6,11,5,5,0
"DG_s02",25,83.805,84.43,85.758,85.773,18,10,10,10,8,76,1.328,1,18,10,8,0,-8
"DG_s02",26,86.773,87.398,88.805,88.805,10,10,6,14,0,76,1.407,0,6,14,8,8,0
"DG_s02",27,89.805,90.43,91.195,91.211,10,10,10,22,0,76,0.765,0,10,22,12,12,0
"DG_s02",28,92.211,92.836,94.633,94.648,10,10,30,10,0,76,1.797,0,30,10,20,0,-20
"DG_s02",29,95.648,96.273,97.492,97.492,18,12,10,10,6,76,1.219,1,18,12,6,0,-6
"DG_s02",30,98.492,99.117,100.351,100.367,18,10,10,10,8,76,1.234,1,18,10,8,0,-8
"DG_s02",31,101.367,101.992,103.101,103.117,13,1,10,10,12,82,1.109,1,13,1,12,0,-12
"DG_s02",32,104.117,104.742,105.742,105.742,16,8,10,10,8,76,1,1,16,8,8,0,-8
"DG_s02",33,106.742,107.367,108.117,108.133,26,10,10,10,16,76,0.75,1,26,10,16,0,-16
"DG_s02",34,109.133,109.758,111.008,111.008,22,13,10,10,9,82,1.25,1,22,13,9,0,-9
"DG_s02",35,112.023,112.648,113.945,113.945,10,10,8,16,0,76,1.297,0,8,16,8,8,0
"DG_s02",36,114.945,115.57,116.539,116.555,12,18,10,10,6,76,0.969,1,12,18,6,6,0
"DG_s02",37,117.57,118.195,119.351,119.351,12,4,10,10,8,76,1.156,1,12,4,8,0,-8
"DG_s02",38,120.367,120.992,121.414,121.43,14,26,10,10,12,76,0.422,1,14,26,12,12,0
"DG_s02",39,122.43,123.055,124.367,124.383,10,10,10,30,0,76,1.312,0,10,30,20,20,0
"DG_s02",40,125.383,126.008,127.476,127.492,10,10,14,14,0,76,1.468,0,14,14,0,0,0
"DG_s02",41,128.492,129.117,130.617,130.633,10,10,6,14,0,76,1.5,0,6,14,8,8,0
"DG_s02",42,131.633,132.258,133.211,133.226,10,10,6,11,0,76,0.953,0,6,11,5,5,0
"DG_s02",43,134.226,134.851,136.43,136.445,30,15,10,10,15,76,1.579,1,30,15,15,0,-15
"DG_s02",44,137.445,138.07,138.898,138.914,10,10,3,17,0,76,0.828,0,3,17,14,14,0
"DG_s02",45,139.914,140.539,141.164,141.18,13,7,10,10,6,76,0.625,1,13,7,6,0,-6
"DG_s02",46,142.18,142.805,144.148,144.164,10,10,12,18,0,76,1.343,0,12,18,6,6,0
"DG_s02",47,145.164,145.789,146.461,146.476,16,8,10,10,8,76,0.672,1,16,8,8,0,-8
"DG_s02",48,147.476,148.101,148.961,148.961,10,10,10,30,0,76,0.86,0,10,30,20,20,0
"DG_s02",49,149.976,150.601,151.289,151.289,18,12,10,10,6,76,0.688,1,18,12,6,0,-6
"DG_s02",50,152.289,152.914,153.836,153.836,10,10,2,2,0,76,0.922,0,2,2,0,0,0
"DG_s02",51,154.836,155.461,155.914,155.93,10,10,3,31,0,76,0.453,0,3,31,28,28,0
"DG_s02",52,156.93,157.555,157.961,157.961,10,22,10,10,12,76,0.406,1,10,22,12,12,0
"DG_s02",53,158.976,159.601,160.398,160.398,10,10,26,10,0,76,0.797,0,26,10,16,0,-16
"DG_s02",54,161.398,162.023,163.023,163.023,30,10,10,10,20,76,1,1,30,10,20,0,-20
"DG_s02",55,164.039,164.664,166.367,166.367,10,10,6,22,0,82,1.703,0,6,22,16,16,0
"DG_s02",56,167.383,168.008,169.773,169.789,10,10,10,18,0,76,1.765,0,10,18,8,8,0
"DG_s02",57,170.789,171.414,172.492,172.492,13,22,10,10,9,76,1.078,1,13,22,9,9,0
"DG_s02",58,173.492,174.117,174.945,174.945,10,10,3,31,0,76,0.828,0,3,31,28,28,0
"DG_s02",59,175.945,176.57,178.086,178.101,26,14,10,10,12,82,1.516,1,26,14,12,0,-12
"DG_s02",60,179.101,179.726,181.133,181.148,10,10,18,2,0,76,1.407,0,18,2,16,0,-16
"DG_s02",61,182.148,182.773,183.648,183.648,16,16,10,10,0,76,0.875,1,16,16,0,0,0
"DG_s02",62,184.648,185.273,186.07,186.07,10,10,8,11,0,76,0.797,0,8,11,3,3,0
"DG_s02",63,187.07,187.695,188.586,188.586,10,10,10,26,0,76,0.891,0,10,26,16,16,0
"DG_s02",64,189.586,190.211,191.164,191.18,15,30,10,10,15,76,0.953,1,15,30,15,15,0
"DG_s02",65,192.18,192.805,193.601,193.601,22,10,10,10,12,76,0.796,1,22,10,12,0,-12
"DG_s02",66,194.601,195.226,196.164,196.18,12,4,10,10,8,76,0.938,1,12,4,8,0,-8
"DG_s02",67,197.18,197.805,198.992,198.992,26,14,10,10,12,82,1.187,1,26,14,12,0,-12
"DG_s02",68,199.992,200.617,202.086,202.101,22,6,10,10,16,76,1.469,1,22,6,16,0,-16
"DG_s02",70,206.726,207.351,208.305,208.32,10,10,8,12,0,76,0.954,0,8,12,4,4,0
"DG_s02",71,209.32,209.945,210.945,210.945,10,10,3,12,0,82,1,0,3,12,9,9,0
"DG_s02",72,211.945,212.57,213.617,213.617,18,2,10,10,16,76,1.047,1,18,2,16,0,-16
"DG_s02",73,214.617,215.242,216.43,216.43,10,10,22,10,0,76,1.188,0,22,10,12,0,-12
"DG_s02",74,217.445,218.086,219.133,219.148,22,13,10,10,9,76,1.047,1,22,13,9,0,-9
"DG_s02",75,220.148,220.773,221.336,221.336,10,10,8,12,0,76,0.563,0,8,12,4,4,0
"DG_s02",76,222.336,222.961,224.164,224.18,10,10,3,12,0,76,1.203,0,3,12,9,9,0
"DG_s02",77,225.18,225.805,226.586,226.601,10,10,10,18,0,76,0.781,0,10,18,8,8,0
"DG_s02",78,227.601,228.226,229.211,229.211,12,12,10,10,0,76,0.985,1,12,12,0,0,0
"DG_s02",79,230.211,230.836,231.867,231.867,10,10,8,8,0,76,1.031,0,8,8,0,0,0
"DG_s02",80,232.867,233.492,234.383,234.383,28,4,10,10,24,76,0.891,1,28,4,24,0,-24
"DG_s02",81,235.383,236.008,237.648,237.648,22,6,10,10,16,82,1.64,1,22,6,16,0,-16
"DG_s02",82,238.648,239.273,240.148,240.148,30,15,10,10,15,76,0.875,1,30,15,15,0,-15
"DG_s02",83,241.148,241.773,242.633,242.633,28,4,10,10,24,76,0.86,1,28,4,24,0,-24
"DG_s02",84,243.648,244.273,244.961,244.961,10,10,4,4,0,76,0.688,0,4,4,0,0,0
"DG_s02",85,245.961,246.586,247.305,247.305,13,7,10,10,6,76,0.719,1,13,7,6,0,-6
"DG_s02",86,248.305,248.93,249.851,249.867,10,10,10,26,0,76,0.921,0,10,26,16,16,0
"DG_s02",87,250.867,251.492,253.414,253.414,10,10,13,22,0,76,1.922,0,13,22,9,9,0
"DG_s02",88,254.414,255.039,255.789,255.789,16,4,10,10,12,76,0.75,1,16,4,12,0,-12
"DG_s02",89,256.789,257.414,258.836,258.836,10,10,8,11,0,76,1.422,0,8,11,3,3,0
"DG_s02",90,259.836,260.461,261.055,261.055,18,18,10,10,0,76,0.594,1,18,18,0,0,0
"DG_s02",91,262.055,262.68,264.164,264.18,8,16,10,10,8,76,1.484,1,8,16,8,8,0
"DG_s02",92,265.18,265.805,266.383,266.383,10,10,3,17,0,76,0.578,0,3,17,14,14,0
"DG_s02",93,267.398,268.023,268.586,268.586,10,10,6,6,0,76,0.563,0,6,6,0,0,0
"DG_s02",94,269.586,270.211,271.758,271.758,10,10,14,26,0,76,1.547,0,14,26,12,12,0
"DG_s02",95,272.758,273.383,274.539,274.555,11,7,10,10,4,76,1.156,1,11,7,4,0,-4
"DG_s02",96,275.555,276.18,276.976,276.976,16,4,10,10,12,76,0.796,1,16,4,12,0,-12
"DG_s02",97,277.976,278.601,279.148,279.148,10,10,13,1,0,76,0.547,0,13,1,12,0,-12
"DG_s02",98,280.164,280.789,281.664,281.664,11,7,10,10,4,76,0.875,1,11,7,4,0,-4
"DG_s02",99,282.664,283.289,285.164,285.164,10,10,6,11,0,82,1.875,0,6,11,5,5,0
"DG_s02",101,289.789,290.414,291.398,291.398,18,10,10,10,8,76,0.984,1,18,10,8,0,-8
"DG_s02",102,292.398,293.023,293.82,293.836,10,10,6,14,0,76,0.797,0,6,14,8,8,0
"DG_s02",103,294.836,295.461,296.492,296.508,10,10,10,22,0,76,1.031,0,10,22,12,12,0
"DG_s02",104,297.508,298.133,298.93,298.945,10,10,30,10,0,76,0.797,0,30,10,20,0,-20
"DG_s02",105,299.945,300.57,301.648,301.648,18,12,10,10,6,76,1.078,1,18,12,6,0,-6
"DG_s02",106,302.648,303.273,303.992,303.992,18,10,10,10,8,76,0.719,1,18,10,8,0,-8
"DG_s02",107,304.992,305.617,307.336,307.336,13,1,10,10,12,82,1.719,1,13,1,12,0,-12
"DG_s02",108,308.336,308.961,309.961,309.961,16,8,10,10,8,76,1,1,16,8,8,0,-8
"DG_s02",109,310.961,311.586,312.445,312.445,26,10,10,10,16,76,0.859,1,26,10,16,0,-16
"DG_s02",111,317.07,317.695,319.18,319.195,10,10,8,16,0,76,1.485,0,8,16,8,8,0
"DG_s02",113,323.82,324.445,325.32,325.32,12,4,10,10,8,76,0.875,1,12,4,8,0,-8
"DG_s02",114,326.32,326.945,328.539,328.555,10,10,14,26,0,82,1.594,0,14,26,12,12,0
"DG_s02",115,329.555,330.18,331.258,331.273,10,10,10,30,0,76,1.078,0,10,30,20,20,0
"DG_s02",117,335.898,336.523,337.961,337.961,10,10,6,14,0,76,1.438,0,6,14,8,8,0
"DG_s02",118,338.961,339.586,340.148,340.148,10,10,6,11,0,76,0.562,0,6,11,5,5,0
"DG_s02",119,341.148,341.773,343.07,343.07,30,15,10,10,15,76,1.297,1,30,15,15,0,-15
"DG_s02",120,344.07,344.695,345.648,345.648,10,10,3,17,0,76,0.953,0,3,17,14,14,0
"DG_s02",121,346.648,347.273,348.351,348.351,13,7,10,10,6,76,1.078,1,13,7,6,0,-6
"DG_s02",122,349.351,349.976,350.633,350.633,10,10,12,18,0,76,0.657,0,12,18,6,6,0
"DG_s02",123,351.633,352.258,352.898,352.914,16,8,10,10,8,76,0.64,1,16,8,8,0,-8
"DG_s02",124,353.914,354.539,355.726,355.726,10,10,10,30,0,76,1.187,0,10,30,20,20,0
"DG_s02",125,356.726,357.351,357.961,357.976,18,12,10,10,6,76,0.61,1,18,12,6,0,-6
"DG_s02",126,358.976,359.601,360.305,360.32,10,10,2,2,0,76,0.704,0,2,2,0,0,0
"DG_s02",127,361.32,361.945,362.633,362.633,10,10,3,31,0,76,0.688,0,3,31,28,28,0
"DG_s02",128,363.633,364.258,364.867,364.883,10,22,10,10,12,76,0.609,1,10,22,12,12,0
"DG_s02",129,365.883,366.508,368.133,368.148,26,10,10,10,16,82,1.625,1,26,10,16,0,-16
"DG_s02",130,369.148,369.773,370.601,370.617,30,10,10,10,20,76,0.828,1,30,10,20,0,-20
"DG_s02",131,371.617,372.242,373.617,373.633,10,10,6,22,0,82,1.375,0,6,22,16,16,0
"DG_s02",132,374.633,375.258,376.398,376.398,10,10,10,18,0,76,1.14,0,10,18,8,8,0
"DG_s02",133,377.414,378.039,379.851,379.867,10,10,13,22,0,82,1.812,0,13,22,9,9,0
"DG_s02",134,380.867,381.492,382.226,382.226,10,10,3,31,0,76,0.734,0,3,31,28,28,0
"DG_s02",135,383.226,383.851,384.508,384.523,10,10,26,14,0,76,0.657,0,26,14,12,0,-12
"DG_s02",136,385.523,386.148,387.117,387.117,10,10,18,2,0,76,0.969,0,18,2,16,0,-16
"DG_s02",137,388.133,388.758,390.445,390.445,16,16,10,10,0,76,1.687,1,16,16,0,0,0
"DG_s02",138,391.461,392.086,392.523,392.523,10,10,8,11,0,76,0.437,0,8,11,3,3,0
"DG_s02",139,393.523,394.148,395.211,395.211,10,10,10,26,0,76,1.063,0,10,26,16,16,0
"DG_s02",140,396.211,396.836,398.336,398.336,10,10,15,30,0,82,1.5,0,15,30,15,15,0
"DG_s02",141,399.336,399.976,401.539,401.555,22,10,10,10,12,76,1.563,1,22,10,12,0,-12
"DG_s02",142,402.555,403.18,404.086,404.086,12,4,10,10,8,76,0.906,1,12,4,8,0,-8
"DG_s02",143,405.086,405.711,406.633,406.633,10,10,26,14,0,76,0.922,0,26,14,12,0,-12
"DG_s02",144,407.633,408.258,409.039,409.039,22,6,10,10,16,76,0.781,1,22,6,16,0,-16
"DG_s02",145,410.055,410.68,411.992,411.992,10,10,6,22,0,82,1.312,0,6,22,16,16,0
"DG_s02",146,412.992,413.617,414.492,414.508,10,10,8,12,0,76,0.875,0,8,12,4,4,0
"DG_s02",147,415.508,416.133,417.523,417.523,10,10,3,12,0,82,1.39,0,3,12,9,9,0
"DG_s02",148,418.523,419.148,419.945,419.961,18,2,10,10,16,76,0.797,1,18,2,16,0,-16
"DG_s02",149,420.961,421.586,423.133,423.133,22,10,10,10,12,82,1.547,1,22,10,12,0,-12
"DG_s02",150,424.133,424.758,426.18,426.195,10,10,22,13,0,82,1.422,0,22,13,9,0,-9
"DG_s02",151,427.195,427.82,429.055,429.055,10,10,8,12,0,76,1.235,0,8,12,4,4,0
"DG_s02",152,430.055,430.68,431.414,431.414,10,10,3,12,0,76,0.734,0,3,12,9,9,0
"DG_s02",153,432.414,433.039,434.039,434.039,10,10,10,18,0,76,1,0,10,18,8,8,0
"DG_s02",154,435.039,435.664,437.148,437.148,12,12,10,10,0,76,1.484,1,12,12,0,0,0
"DG_s02",155,438.148,438.773,439.851,439.851,10,10,8,8,0,76,1.078,0,8,8,0,0,0
"DG_s02",156,440.851,441.476,441.945,441.945,28,4,10,10,24,76,0.469,1,28,4,24,0,-24
"DG_s02",157,442.945,443.57,445.039,445.039,22,6,10,10,16,82,1.469,1,22,6,16,0,-16
"DG_s02",158,446.039,446.664,447.992,447.992,30,15,10,10,15,76,1.328,1,30,15,15,0,-15
"DG_s02",159,448.992,449.617,450.351,450.351,28,4,10,10,24,76,0.734,1,28,4,24,0,-24
"DG_s02",160,451.351,451.976,453.133,453.133,10,10,4,4,0,76,1.157,0,4,4,0,0,0
"DG_s02",161,454.133,454.758,455.601,455.601,13,7,10,10,6,76,0.843,1,13,7,6,0,-6
"DG_s02",162,456.601,457.226,457.883,457.883,10,10,10,26,0,76,0.657,0,10,26,16,16,0
"DG_s02",163,458.883,459.508,460.18,460.195,10,10,13,22,0,76,0.672,0,13,22,9,9,0
"DG_s02",164,461.195,461.82,462.726,462.726,16,4,10,10,12,76,0.906,1,16,4,12,0,-12
"DG_s02",165,463.726,464.351,465.023,465.023,10,10,8,11,0,76,0.672,0,8,11,3,3,0
"DG_s02",166,466.023,466.648,467.492,467.492,18,18,10,10,0,76,0.844,1,18,18,0,0,0
"DG_s02",167,468.492,469.117,470.18,470.18,8,16,10,10,8,76,1.063,1,8,16,8,8,0
"DG_s02",168,471.18,471.805,472.586,472.601,10,10,3,17,0,76,0.781,0,3,17,14,14,0
"DG_s02",169,473.601,474.226,474.867,474.867,10,10,6,6,0,76,0.641,0,6,6,0,0,0
"DG_s02",170,475.867,476.492,477.976,477.976,10,10,14,26,0,76,1.484,0,14,26,12,12,0
"DG_s02",171,478.976,479.601,480.414,480.414,11,7,10,10,4,76,0.813,1,11,7,4,0,-4
"DG_s02",172,481.43,482.055,482.789,482.789,16,4,10,10,12,76,0.734,1,16,4,12,0,-12
"DG_s02",173,483.805,484.43,484.898,484.914,10,10,13,1,0,76,0.468,0,13,1,12,0,-12
"DG_s02",174,485.914,486.539,487.289,487.289,11,7,10,10,4,76,0.75,1,11,7,4,0,-4
"DG_s02",175,488.289,488.914,490.101,490.101,10,10,6,11,0,82,1.187,0,6,11,5,5,0
"DG_s02",176,491.117,491.742,493.492,493.492,10,10,15,30,0,82,1.75,0,15,30,15,15,0
"DG_s02",177,494.492,495.117,496.07,496.07,18,10,10,10,8,76,0.953,1,18,10,8,0,-8
"DG_s02",178,497.07,497.695,498.93,498.93,10,10,6,14,0,76,1.235,0,6,14,8,8,0
"DG_s02",179,499.93,500.555,501.336,501.351,10,10,10,22,0,76,0.781,0,10,22,12,12,0
"DG_s02",180,502.351,502.976,503.867,503.867,10,10,30,10,0,76,0.891,0,30,10,20,0,-20
"DG_s02",181,504.867,505.492,506.805,506.805,18,12,10,10,6,76,1.313,1,18,12,6,0,-6
"DG_s02",182,507.82,508.445,509.133,509.133,18,10,10,10,8,76,0.688,1,18,10,8,0,-8
"DG_s02",183,510.133,510.758,512.461,512.461,13,1,10,10,12,82,1.703,1,13,1,12,0,-12
"DG_s02",184,513.461,514.086,515.211,515.226,16,8,10,10,8,76,1.125,1,16,8,8,0,-8
"DG_s02",185,516.226,516.851,517.164,517.164,26,10,10,10,16,76,0.313,1,26,10,16,0,-16
"DG_s02",186,518.164,518.789,520.07,520.07,22,13,10,10,9,82,1.281,1,22,13,9,0,-9
"DG_s02",187,521.07,521.695,523.461,523.461,10,10,8,16,0,76,1.766,0,8,16,8,8,0
"DG_s02",188,524.476,525.101,526.851,526.867,10,10,12,18,0,82,1.75,0,12,18,6,6,0
"DG_s02",189,527.867,528.492,529.336,529.351,12,4,10,10,8,76,0.844,1,12,4,8,0,-8
"DG_s02",190,530.351,530.976,532.273,532.289,10,10,14,26,0,82,1.297,0,14,26,12,12,0
"DG_s02",191,533.289,533.914,534.93,534.93,10,10,10,30,0,76,1.016,0,10,30,20,20,0
"DG_s02",192,535.93,536.555,537.43,537.43,10,10,14,14,0,76,0.875,0,14,14,0,0,0
"DG_s02",193,538.43,539.055,539.805,539.805,10,10,6,14,0,76,0.75,0,6,14,8,8,0
"DG_s02",194,540.82,541.445,542.289,542.305,10,10,6,11,0,76,0.844,0,6,11,5,5,0
"DG_s02",195,543.305,543.93,545.398,545.398,10,10,30,15,0,82,1.468,0,30,15,15,0,-15
"DG_s02",196,546.398,547.023,547.773,547.773,10,10,3,17,0,76,0.75,0,3,17,14,14,0
"DG_s02",197,548.789,549.414,550.242,550.242,13,7,10,10,6,76,0.828,1,13,7,6,0,-6
"DG_s02",198,551.242,551.867,552.898,552.914,10,10,12,18,0,76,1.031,0,12,18,6,6,0
"DG_s02",199,553.914,554.539,555.461,555.461,16,8,10,10,8,76,0.922,1,16,8,8,0,-8
"DG_s02",200,556.461,557.086,557.992,557.992,10,10,10,30,0,76,0.906,0,10,30,20,20,0
"DG_s03",1,-0.657,0,0.89,0.89,10,10,10,18,0,76,0.89,0,10,18,8,8,0
"DG_s03",2,1.89,2.547,3.359,3.375,12,12,10,10,0,76,0.812,1,12,12,0,0,0
"DG_s03",3,4.375,5.031,5.906,5.906,10,10,8,8,0,76,0.875,0,8,8,0,0,0
"DG_s03",4,6.906,7.562,8.187,8.187,28,4,10,10,24,76,0.625,1,28,4,24,0,-24
"DG_s03",5,9.187,9.843,10.547,10.547,22,6,10,10,16,82,0.704,1,22,6,16,0,-16
"DG_s03",6,11.547,12.203,13.031,13.047,30,15,10,10,15,76,0.828,1,30,15,15,0,-15
"DG_s03",7,14.047,14.703,15.64,15.64,28,4,10,10,24,76,0.937,1,28,4,24,0,-24
"DG_s03",8,16.656,17.312,18.375,18.375,10,10,4,4,0,76,1.063,0,4,4,0,0,0
"DG_s03",9,19.375,20.031,20.812,20.828,13,7,10,10,6,76,0.781,1,13,7,6,0,-6
"DG_s03",10,21.828,22.484,23.89,23.89,10,10,10,26,0,76,1.406,0,10,26,16,16,0
"DG_s03",11,24.89,25.547,26.765,26.765,13,22,10,10,9,82,1.218,1,13,22,9,9,0
"DG_s03",12,27.765,28.422,29.234,29.234,16,4,10,10,12,76,0.812,1,16,4,12,0,-12
"DG_s03",14,33.89,34.547,35.656,35.656,18,18,10,10,0,76,1.109,1,18,18,0,0,0
"DG_s03",15,36.672,37.328,38.343,38.343,10,10,8,16,0,82,1.015,0,8,16,8,8,0
"DG_s03",16,39.343,40,41.031,41.047,10,10,3,17,0,76,1.031,0,3,17,14,14,0
"DG_s03",17,42.047,42.703,43.547,43.547,10,10,6,6,0,76,0.844,0,6,6,0,0,0
"DG_s03",18,44.547,45.203,46.422,46.422,14,26,10,10,12,82,1.219,1,14,26,12,12,0
"DG_s03",19,47.422,48.078,49.359,49.375,11,7,10,10,4,76,1.281,1,11,7,4,0,-4
"DG_s03",20,50.375,51.031,51.781,51.797,16,4,10,10,12,76,0.75,1,16,4,12,0,-12
"DG_s03",21,52.797,53.453,54.312,54.312,13,1,10,10,12,82,0.859,1,13,1,12,0,-12
"DG_s03",22,55.328,55.984,57,57,11,7,10,10,4,76,1.016,1,11,7,4,0,-4
"DG_s03",23,58,58.656,59.703,59.718,10,10,6,11,0,82,1.047,0,6,11,5,5,0
"DG_s03",24,60.718,61.375,62.797,62.797,10,10,15,30,0,82,1.422,0,15,30,15,15,0
"DG_s03",25,63.797,64.453,65.578,65.578,18,10,10,10,8,76,1.125,1,18,10,8,0,-8
"DG_s03",26,66.578,67.234,68.578,68.578,10,10,6,14,0,76,1.344,0,6,14,8,8,0
"DG_s03",27,69.578,70.234,71.843,71.843,10,10,10,22,0,76,1.609,0,10,22,12,12,0
"DG_s03",28,72.843,73.5,74.406,74.422,30,10,10,10,20,82,0.906,1,30,10,20,0,-20
"DG_s03",29,75.422,76.078,76.984,76.984,18,12,10,10,6,76,0.906,1,18,12,6,0,-6
"DG_s03",30,77.984,78.64,80,80.015,18,10,10,10,8,76,1.36,1,18,10,8,0,-8
"DG_s03",31,81.015,81.672,82.781,82.797,13,1,10,10,12,82,1.109,1,13,1,12,0,-12
"DG_s03",32,83.797,84.453,85.468,85.484,16,8,10,10,8,76,1.015,1,16,8,8,0,-8
"DG_s03",33,86.484,87.14,87.781,87.797,26,10,10,10,16,76,0.641,1,26,10,16,0,-16
"DG_s03",34,88.797,89.453,90.093,90.109,22,13,10,10,9,82,0.64,1,22,13,9,0,-9
"DG_s03",35,91.109,91.765,93.015,93.015,10,10,8,16,0,76,1.25,0,8,16,8,8,0
"DG_s03",36,94.015,94.672,96.625,96.625,12,18,10,10,6,76,1.953,1,12,18,6,6,0
"DG_s03",37,97.625,98.281,99.531,99.531,12,4,10,10,8,76,1.25,1,12,4,8,0,-8
"DG_s03",38,100.531,101.187,102.468,102.484,14,26,10,10,12,76,1.281,1,14,26,12,12,0
"DG_s03",39,103.484,104.14,105.375,105.375,10,10,10,30,0,76,1.235,0,10,30,20,20,0
"DG_s03",40,106.375,107.031,108.64,108.64,10,10,14,14,0,76,1.609,0,14,14,0,0,0
"DG_s03",41,109.656,110.312,111.64,111.64,10,10,6,14,0,76,1.328,0,6,14,8,8,0
"DG_s03",42,112.64,113.297,114.687,114.703,10,10,6,11,0,76,1.39,0,6,11,5,5,0
"DG_s03",43,115.703,116.359,117.484,117.5,30,15,10,10,15,76,1.125,1,30,15,15,0,-15
"DG_s03",44,118.5,119.156,120.328,120.328,10,10,3,17,0,76,1.172,0,3,17,14,14,0
"DG_s03",45,121.343,122,123.109,123.109,13,7,10,10,6,76,1.109,1,13,7,6,0,-6
"DG_s03",46,124.109,124.765,125.687,125.687,12,18,10,10,6,82,0.922,1,12,18,6,6,0
"DG_s03",47,126.687,127.343,128.109,128.109,16,8,10,10,8,76,0.766,1,16,8,8,0,-8
"DG_s03",48,129.109,129.765,130.89,130.89,10,10,10,30,0,76,1.125,0,10,30,20,20,0
"DG_s03",49,131.89,132.547,134.062,134.062,18,12,10,10,6,76,1.515,1,18,12,6,0,-6
"DG_s03",50,135.062,135.718,136.843,136.843,10,10,2,2,0,76,1.125,0,2,2,0,0,0
"DG_s03",51,137.843,138.5,140.265,140.265,10,10,3,31,0,76,1.765,0,3,31,28,28,0
"DG_s03",52,141.265,141.922,143.781,143.781,10,10,10,22,0,82,1.859,0,10,22,12,12,0
"DG_s03",53,144.781,145.437,147.031,147.047,26,10,10,10,16,82,1.594,1,26,10,16,0,-16
"DG_s03",54,148.047,148.703,149.703,149.703,30,10,10,10,20,76,1,1,30,10,20,0,-20
"DG_s03",55,150.703,151.359,153.078,153.093,10,10,6,22,0,82,1.719,0,6,22,16,16,0
"DG_s03",56,154.093,154.75,156.609,156.609,10,10,10,18,0,76,1.859,0,10,18,8,8,0
"DG_s03",57,157.625,158.281,160.265,160.265,13,22,10,10,9,76,1.984,1,13,22,9,9,0
"DG_s03",58,161.281,161.937,163.547,163.547,10,10,3,31,0,76,1.61,0,3,31,28,28,0
"DG_s03",59,164.547,165.203,166.375,166.375,26,14,10,10,12,82,1.172,1,26,14,12,0,-12
"DG_s03",60,167.375,168.031,169.718,169.734,18,2,10,10,16,82,1.687,1,18,2,16,0,-16
"DG_s03",61,170.734,171.39,173.218,173.218,16,16,10,10,0,76,1.828,1,16,16,0,0,0
"DG_s03",63,177.875,178.531,179.859,179.859,10,10,10,26,0,76,1.328,0,10,26,16,16,0
"DG_s03",64,180.859,181.515,183.343,183.343,10,10,15,30,0,82,1.828,0,15,30,15,15,0
"DG_s03",65,184.343,185,186.75,186.765,22,10,10,10,12,76,1.75,1,22,10,12,0,-12
"DG_s03",66,187.765,188.422,189.937,189.937,12,4,10,10,8,76,1.515,1,12,4,8,0,-8
"DG_s03",67,190.937,191.593,192.5,192.515,26,14,10,10,12,82,0.907,1,26,14,12,0,-12
"DG_s03",68,193.515,194.172,195.687,195.687,22,6,10,10,16,76,1.515,1,22,6,16,0,-16
"DG_s03",69,196.687,197.343,198.781,198.797,10,10,6,22,0,82,1.438,0,6,22,16,16,0
"DG_s03",70,199.797,200.453,202.218,202.218,10,10,8,12,0,76,1.765,0,8,12,4,4,0
"DG_s03",71,203.218,203.875,205.547,205.547,10,10,3,12,0,82,1.672,0,3,12,9,9,0
"DG_s03",72,206.547,207.203,208.468,208.468,18,2,10,10,16,76,1.265,1,18,2,16,0,-16
"DG_s03",73,209.468,210.125,211.234,211.234,22,10,10,10,12,82,1.109,1,22,10,12,0,-12
"DG_s03",74,212.234,212.89,214.343,214.359,22,13,10,10,9,76,1.453,1,22,13,9,0,-9
"DG_s03",75,215.359,216.015,217.515,217.515,10,10,8,12,0,76,1.5,0,8,12,4,4,0
"DG_s03",76,218.515,219.172,220.906,220.906,10,10,3,12,0,76,1.734,0,3,12,9,9,0
"DG_s03",78,225.562,226.218,227.25,227.25,12,12,10,10,0,76,1.032,1,12,12,0,0,0
"DG_s03",79,228.25,228.906,229.922,229.922,10,10,8,8,0,76,1.016,0,8,8,0,0,0
"DG_s03",80,230.922,231.578,232.297,232.297,28,4,10,10,24,76,0.719,1,28,4,24,0,-24
"DG_s03",81,233.297,233.953,234.703,234.703,22,6,10,10,16,82,0.75,1,22,6,16,0,-16
"DG_s03",82,235.703,236.359,236.984,236.984,30,15,10,10,15,76,0.625,1,30,15,15,0,-15
"DG_s03",83,237.984,238.64,239.703,239.718,28,4,10,10,24,76,1.063,1,28,4,24,0,-24
"DG_s03",84,240.718,241.375,242.625,242.625,10,10,4,4,0,76,1.25,0,4,4,0,0,0
"DG_s03",85,243.625,244.281,245.297,245.297,13,7,10,10,6,76,1.016,1,13,7,6,0,-6
"DG_s03",86,246.312,246.968,248.453,248.453,10,10,10,26,0,76,1.485,0,10,26,16,16,0
"DG_s03",87,249.453,250.109,252,252,13,22,10,10,9,82,1.891,1,13,22,9,9,0
"DG_s03",88,253.015,253.672,254.89,254.89,16,4,10,10,12,76,1.218,1,16,4,12,0,-12
"DG_s03",89,255.89,256.547,257.843,257.843,10,10,8,11,0,76,1.296,0,8,11,3,3,0
"DG_s03",90,258.843,259.5,260.625,260.625,18,18,10,10,0,76,1.125,1,18,18,0,0,0
"DG_s03",91,261.64,262.297,264.234,264.234,10,10,8,16,0,82,1.937,0,8,16,8,8,0
"DG_s03",92,265.234,265.89,267.39,267.406,10,10,3,17,0,76,1.5,0,3,17,14,14,0
"DG_s03",93,268.406,269.062,270.218,270.218,10,10,6,6,0,76,1.156,0,6,6,0,0,0
"DG_s03",94,271.218,271.875,273.468,273.468,14,26,10,10,12,82,1.593,1,14,26,12,12,0
"DG_s03",95,274.468,275.125,276.312,276.312,11,7,10,10,4,76,1.187,1,11,7,4,0,-4
"DG_s03",96,277.328,277.984,278.75,278.75,16,4,10,10,12,76,0.766,1,16,4,12,0,-12
"DG_s03",97,279.75,280.406,281.593,281.593,10,10,13,1,0,76,1.187,0,13,1,12,0,-12
"DG_s03",98,282.593,283.25,284.437,284.437,11,7,10,10,4,76,1.187,1,11,7,4,0,-4
"DG_s03",99,285.437,286.093,286.89,286.89,10,10,6,11,0,82,0.797,0,6,11,5,5,0
"DG_s03",100,287.89,288.547,290.062,290.078,15,30,10,10,15,76,1.515,1,15,30,15,15,0
"DG_s03",101,291.078,291.734,293.234,293.234,18,10,10,10,8,76,1.5,1,18,10,8,0,-8
"DG_s03",102,294.234,294.89,296.015,296.015,10,10,6,14,0,76,1.125,0,6,14,8,8,0
"DG_s03",103,297.031,297.687,298.562,298.562,10,10,10,22,0,76,0.875,0,10,22,12,12,0
"DG_s03",104,299.562,300.218,301.187,301.187,30,10,10,10,20,82,0.969,1,30,10,20,0,-20
"DG_s03",105,302.187,302.843,303.625,303.625,18,12,10,10,6,76,0.782,1,18,12,6,0,-6
"DG_s03",106,304.625,305.281,306.468,306.468,18,10,10,10,8,76,1.187,1,18,10,8,0,-8
"DG_s03",107,307.468,308.125,309.031,309.047,13,1,10,10,12,82,0.906,1,13,1,12,0,-12
"DG_s03",108,310.047,310.703,311.968,311.968,16,8,10,10,8,76,1.265,1,16,8,8,0,-8
"DG_s03",109,312.984,313.64,314.343,314.343,26,10,10,10,16,76,0.703,1,26,10,16,0,-16
"DG_s03",110,315.343,316,316.781,316.797,22,13,10,10,9,82,0.781,1,22,13,9,0,-9
"DG_s03",113,325.109,325.765,327.093,327.093,12,4,10,10,8,76,1.328,1,12,4,8,0,-8
"DG_s03",115,331.75,332.406,334.062,334.062,10,10,10,30,0,76,1.656,0,10,30,20,20,0
"DG_s03",116,335.062,335.718,337.172,337.187,10,10,14,14,0,76,1.454,0,14,14,0,0,0
"DG_s03",117,338.187,338.843,340.078,340.093,10,10,6,14,0,76,1.235,0,6,14,8,8,0
"DG_s03",118,341.093,341.75,343.047,343.047,10,10,6,11,0,76,1.297,0,6,11,5,5,0
"DG_s03",119,344.047,344.703,345.593,345.593,30,15,10,10,15,76,0.89,1,30,15,15,0,-15
"DG_s03",120,346.609,347.265,348.859,348.875,10,10,3,17,0,76,1.594,0,3,17,14,14,0
"DG_s03",121,349.875,350.531,351.828,351.828,13,7,10,10,6,76,1.297,1,13,7,6,0,-6
"DG_s03",122,352.828,353.484,355.062,355.078,10,10,12,18,0,76,1.578,0,12,18,6,6,0
"DG_s03",123,356.078,356.734,358.093,358.109,16,8,10,10,8,76,1.359,1,16,8,8,0,-8
"DG_s03",124,359.109,359.765,360.937,360.937,10,10,10,30,0,76,1.172,0,10,30,20,20,0
"DG_s03",125,361.937,362.593,363.75,363.765,18,12,10,10,6,76,1.157,1,18,12,6,0,-6
"DG_s03",126,364.765,365.422,366.687,366.687,10,10,2,2,0,76,1.265,0,2,2,0,0,0
"DG_s03",127,367.687,368.343,369.453,369.468,10,10,3,31,0,76,1.11,0,3,31,28,28,0
"DG_s03",129,374.125,374.781,375.687,375.703,26,10,10,10,16,82,0.906,1,26,10,16,0,-16
"DG_s03",130,376.703,377.359,378.172,378.172,30,10,10,10,20,76,0.813,1,30,10,20,0,-20
"DG_s03",131,379.172,379.828,381.125,381.14,10,10,6,22,0,82,1.297,0,6,22,16,16,0
"DG_s03",132,382.14,382.797,384.687,384.687,10,18,10,10,8,82,1.89,1,10,18,8,8,0
"DG_s03",134,389.343,390,390.922,390.922,10,10,3,31,0,76,0.922,0,3,31,28,28,0
"DG_s03",135,391.922,392.578,393.797,393.812,26,14,10,10,12,82,1.219,1,26,14,12,0,-12
"DG_s03",136,394.812,395.468,396.718,396.734,10,10,18,2,0,76,1.25,0,18,2,16,0,-16
"DG_s03",137,397.734,398.39,399.515,399.515,16,16,10,10,0,76,1.125,1,16,16,0,0,0
"DG_s03",138,400.515,401.172,402.343,402.343,10,10,8,11,0,76,1.171,0,8,11,3,3,0
"DG_s03",139,403.359,404.015,405.359,405.375,10,10,10,26,0,76,1.344,0,10,26,16,16,0
"DG_s03",140,406.375,407.031,408.625,408.625,10,10,15,30,0,82,1.594,0,15,30,15,15,0
"DG_s03",141,409.64,410.297,410.875,410.875,22,10,10,10,12,76,0.578,1,22,10,12,0,-12
"DG_s03",142,411.875,412.531,414.203,414.203,12,4,10,10,8,76,1.672,1,12,4,8,0,-8
"DG_s03",143,415.203,415.859,416.75,416.75,26,14,10,10,12,82,0.891,1,26,14,12,0,-12
"DG_s03",144,417.75,418.406,419.156,419.172,22,6,10,10,16,76,0.75,1,22,6,16,0,-16
"DG_s03",145,420.172,420.828,422.593,422.593,10,10,6,22,0,82,1.765,0,6,22,16,16,0
"DG_s03",146,423.593,424.25,425.703,425.703,10,10,8,12,0,76,1.453,0,8,12,4,4,0
"DG_s03",147,426.703,427.359,428.406,428.406,10,10,3,12,0,82,1.047,0,3,12,9,9,0
"DG_s03",148,429.406,430.062,431.734,431.75,18,2,10,10,16,76,1.672,1,18,2,16,0,-16
"DG_s03",149,432.75,433.406,434.078,434.078,22,10,10,10,12,82,0.672,1,22,10,12,0,-12
"DG_s03",150,435.078,435.734,436.547,436.547,22,13,10,10,9,76,0.813,1,22,13,9,0,-9
"DG_s03",151,437.547,438.203,439.437,439.453,10,10,8,12,0,76,1.234,0,8,12,4,4,0
"DG_s03",152,440.453,441.109,442.156,442.172,10,10,3,12,0,76,1.047,0,3,12,9,9,0
"DG_s03",153,443.172,443.828,445.64,445.64,10,10,10,18,0,76,1.812,0,10,18,8,8,0
"DG_s03",154,446.64,447.297,448.687,448.703,12,12,10,10,0,76,1.39,1,12,12,0,0,0
"DG_s03",155,449.703,450.359,451.625,451.625,10,10,8,8,0,76,1.266,0,8,8,0,0,0
"DG_s03",156,452.625,453.281,454.375,454.375,28,4,10,10,24,76,1.094,1,28,4,24,0,-24
"DG_s03",157,455.375,456.031,456.843,456.859,22,6,10,10,16,82,0.812,1,22,6,16,0,-16
"DG_s03",158,457.859,458.515,459.718,459.734,30,15,10,10,15,76,1.203,1,30,15,15,0,-15
"DG_s03",159,460.734,461.39,462.484,462.5,28,4,10,10,24,76,1.094,1,28,4,24,0,-24
"DG_s03",160,463.5,464.156,466.047,466.047,10,10,4,4,0,76,1.891,0,4,4,0,0,0
"DG_s03",162,470.703,471.359,473.062,473.062,10,10,10,26,0,76,1.703,0,10,26,16,16,0
"DG_s03",163,474.062,474.718,476.14,476.156,10,10,13,22,0,76,1.422,0,13,22,9,9,0
"DG_s03",164,477.156,477.812,478.703,478.718,16,4,10,10,12,76,0.891,1,16,4,12,0,-12
"DG_s03",165,479.718,480.375,482.14,482.14,10,10,8,11,0,76,1.765,0,8,11,3,3,0
"DG_s03",166,483.14,483.797,485.297,485.297,18,18,10,10,0,76,1.5,1,18,18,0,0,0
"DG_s03",167,486.312,486.968,488.625,488.625,10,10,8,16,0,82,1.657,0,8,16,8,8,0
"DG_s03",168,489.64,490.297,492.14,492.156,10,10,3,17,0,76,1.843,0,3,17,14,14,0
"DG_s03",169,493.156,493.812,495.656,495.656,10,10,6,6,0,76,1.844,0,6,6,0,0,0
"DG_s03",170,496.656,497.312,498.953,498.953,10,10,14,26,0,76,1.641,0,14,26,12,12,0
"DG_s03",171,499.968,500.625,502.39,502.39,11,7,10,10,4,76,1.765,1,11,7,4,0,-4
"DG_s03",172,503.39,504.047,505.281,505.281,16,4,10,10,12,76,1.234,1,16,4,12,0,-12
"DG_s03",173,506.281,506.937,508.562,508.562,13,1,10,10,12,82,1.625,1,13,1,12,0,-12
"DG_s03",174,509.562,510.218,511.5,511.515,11,7,10,10,4,76,1.282,1,11,7,4,0,-4
"DG_s03",175,512.515,513.172,515,515,10,10,6,11,0,82,1.828,0,6,11,5,5,0
"DG_s03",177,519.672,520.328,522.156,522.172,18,10,10,10,8,76,1.828,1,18,10,8,0,-8
"DG_s03",178,523.172,523.828,525.078,525.078,10,10,6,14,0,76,1.25,0,6,14,8,8,0
"DG_s03",179,526.078,526.734,528.203,528.203,10,10,10,22,0,76,1.469,0,10,22,12,12,0
"DG_s03",180,529.203,529.859,530.75,530.75,30,10,10,10,20,82,0.891,1,30,10,20,0,-20
"DG_s03",181,531.75,532.406,534.297,534.297,10,10,18,12,0,82,1.891,0,18,12,6,0,-6
"DG_s03",182,535.297,535.953,537.297,537.297,18,10,10,10,8,76,1.344,1,18,10,8,0,-8
"DG_s03",183,538.297,538.953,540.203,540.203,13,1,10,10,12,82,1.25,1,13,1,12,0,-12
"DG_s03",184,541.203,541.859,543.281,543.281,16,8,10,10,8,76,1.422,1,16,8,8,0,-8
"DG_s03",185,544.297,544.953,545.859,545.859,26,10,10,10,16,76,0.906,1,26,10,16,0,-16
"DG_s03",186,546.859,547.515,548.422,548.437,22,13,10,10,9,82,0.907,1,22,13,9,0,-9
"DG_s03",187,549.437,550.093,551.578,551.578,10,10,8,16,0,76,1.485,0,8,16,8,8,0
"DG_s03",188,552.578,553.234,554.593,554.593,10,10,12,18,0,82,1.359,0,12,18,6,6,0
"DG_s03",189,555.593,556.25,557.828,557.843,12,4,10,10,8,76,1.578,1,12,4,8,0,-8
"DG_s03",191,562.5,563.156,564.406,564.406,10,10,10,30,0,76,1.25,0,10,30,20,20,0
"DG_s03",192,565.406,566.062,567.375,567.39,10,10,14,14,0,76,1.313,0,14,14,0,0,0
"DG_s03",193,568.39,569.047,570.343,570.343,10,10,6,14,0,76,1.296,0,6,14,8,8,0
"DG_s03",194,571.359,572.015,573.25,573.25,10,10,6,11,0,76,1.235,0,6,11,5,5,0
"DG_s03",195,574.25,574.906,576.297,576.297,30,15,10,10,15,76,1.391,1,30,15,15,0,-15
"DG_s03",196,577.297,577.953,579.343,579.343,10,10,3,17,0,76,1.39,0,3,17,14,14,0
"DG_s03",197,580.343,581,582.156,582.156,13,7,10,10,6,76,1.156,1,13,7,6,0,-6
"DG_s03",198,583.156,583.812,585.312,585.312,10,10,12,18,0,76,1.5,0,12,18,6,6,0
"DG_s03",199,586.312,586.968,588.531,588.531,16,8,10,10,8,76,1.563,1,16,8,8,0,-8
"DG_s03",200,589.531,590.187,591.75,591.75,10,10,10,30,0,76,1.563,0,10,30,20,20,0
"DG_s04",1,-0.75,0,1.297,1.312,10,10,10,18,0,76,1.297,0,10,18,8,8,0
"DG_s04",2,2.312,3.062,4.531,4.547,12,12,10,10,0,76,1.469,1,12,12,0,0,0
"DG_s04",3,5.547,6.297,7.531,7.531,10,10,8,8,0,76,1.234,0,8,8,0,0,0
"DG_s04",4,8.531,9.281,10.797,10.812,28,4,10,10,24,76,1.516,1,28,4,24,0,-24
"DG_s04",5,11.812,12.562,13.797,13.797,22,6,10,10,16,82,1.235,1,22,6,16,0,-16
"DG_s04",6,14.812,15.562,17.468,17.468,30,15,10,10,15,76,1.906,1,30,15,15,0,-15
"DG_s04",7,18.468,19.218,20.922,20.937,28,4,10,10,24,76,1.704,1,28,4,24,0,-24
"DG_s04",9,25.687,26.437,27.843,27.843,10,10,13,7,0,82,1.406,0,13,7,6,0,-6
"DG_s04",10,28.859,29.609,31.547,31.562,10,10,10,26,0,76,1.938,0,10,26,16,16,0
"DG_s04",11,32.562,33.312,34.75,34.75,10,10,13,22,0,76,1.438,0,13,22,9,9,0
"DG_s04",12,35.765,36.515,38.453,38.453,16,4,10,10,12,76,1.938,1,16,4,12,0,-12
"DG_s04",13,39.453,40.203,41.75,41.75,10,10,8,11,0,76,1.547,0,8,11,3,3,0
"DG_s04",14,42.765,43.515,44.843,44.859,18,18,10,10,0,76,1.328,1,18,18,0,0,0
"DG_s04",15,45.859,46.609,48.047,48.047,10,10,8,16,0,82,1.438,0,8,16,8,8,0
"DG_s04",16,49.047,49.797,50.984,51,10,10,3,17,0,76,1.187,0,3,17,14,14,0
"DG_s04",17,52,52.75,53.937,53.953,10,10,6,6,0,76,1.187,0,6,6,0,0,0
"DG_s04",18,54.953,55.703,57.015,57.031,10,10,14,26,0,76,1.312,0,14,26,12,12,0
"DG_s04",20,61.781,62.531,63.843,63.843,16,4,10,10,12,76,1.312,1,16,4,12,0,-12
"DG_s04",21,64.843,65.593,66.937,66.953,13,1,10,10,12,82,1.344,1,13,1,12,0,-12
"DG_s04",22,67.953,68.703,70.343,70.359,11,7,10,10,4,76,1.64,1,11,7,4,0,-4
"DG_s04",23,71.359,72.109,73.25,73.25,10,10,6,11,0,82,1.141,0,6,11,5,5,0
"DG_s04",24,74.25,75,76.078,76.078,10,10,15,30,0,82,1.078,0,15,30,15,15,0
"DG_s04",25,77.078,77.828,78.937,78.937,18,10,10,10,8,76,1.109,1,18,10,8,0,-8
"DG_s04",26,79.937,80.687,82.218,82.218,10,10,6,14,0,76,1.531,0,6,14,8,8,0
"DG_s04",27,83.218,83.968,85.281,85.297,10,10,10,22,0,76,1.313,0,10,22,12,12,0
"DG_s04",28,86.297,87.047,88.093,88.093,30,10,10,10,20,82,1.046,1,30,10,20,0,-20
"DG_s04",29,89.093,89.843,91,91,18,12,10,10,6,76,1.157,1,18,12,6,0,-6
"DG_s04",30,92,92.75,94.156,94.156,18,10,10,10,8,76,1.406,1,18,10,8,0,-8
"DG_s04",31,95.156,95.906,97.703,97.703,13,1,10,10,12,82,1.797,1,13,1,12,0,-12
"DG_s04",32,98.703,99.453,100.89,100.906,16,8,10,10,8,76,1.437,1,16,8,8,0,-8
"DG_s04",33,101.906,102.656,103.968,103.984,26,10,10,10,16,76,1.312,1,26,10,16,0,-16
"DG_s04",34,104.984,105.734,107.406,107.406,22,13,10,10,9,82,1.672,1,22,13,9,0,-9
"DG_s04",35,108.406,109.156,110.703,110.703,10,10,8,16,0,76,1.547,0,8,16,8,8,0
"DG_s04",36,111.703,112.453,113.812,113.812,10,10,12,18,0,82,1.359,0,12,18,6,6,0
"DG_s04",37,114.828,115.578,117.422,117.422,12,4,10,10,8,76,1.844,1,12,4,8,0,-8
"DG_s04",38,118.422,119.172,120.078,120.078,10,10,14,26,0,82,0.906,0,14,26,12,12,0
"DG_s04",39,121.078,121.828,123.14,123.14,10,10,10,30,0,76,1.312,0,10,30,20,20,0
"DG_s04",40,124.14,124.89,126.172,126.172,14,14,10,10,0,82,1.282,1,14,14,0,0,0
"DG_s04",41,127.187,127.937,129.484,129.484,10,10,6,14,0,76,1.547,0,6,14,8,8,0
"DG_s04",42,130.5,131.25,132.547,132.562,10,10,6,11,0,76,1.297,0,6,11,5,5,0
"DG_s04",43,133.562,134.312,135.562,135.578,30,15,10,10,15,76,1.25,1,30,15,15,0,-15
"DG_s04",44,136.578,137.328,138.609,138.609,10,10,3,17,0,76,1.281,0,3,17,14,14,0
"DG_s04",46,143.359,144.109,145.484,145.484,10,10,12,18,0,76,1.375,0,12,18,6,6,0
"DG_s04",47,146.5,147.25,148.422,148.422,16,8,10,10,8,76,1.172,1,16,8,8,0,-8
"DG_s04",48,149.422,150.172,151.297,151.312,10,10,10,30,0,76,1.125,0,10,30,20,20,0
"DG_s04",49,152.312,153.062,154.812,154.812,18,12,10,10,6,76,1.75,1,18,12,6,0,-6
"DG_s04",50,155.812,156.562,157.453,157.453,10,10,2,2,0,76,0.891,0,2,2,0,0,0
"DG_s04",51,158.468,159.218,160.375,160.375,10,10,3,31,0,76,1.157,0,3,31,28,28,0
"DG_s04",52,161.375,162.125,163.14,163.14,10,10,10,22,0,82,1.015,0,10,22,12,12,0
"DG_s04",53,164.156,164.906,166.172,166.172,26,10,10,10,16,82,1.266,1,26,10,16,0,-16
"DG_s04",54,167.187,167.937,168.859,168.859,30,10,10,10,20,76,0.922,1,30,10,20,0,-20
"DG_s04",55,169.875,170.625,171.828,171.828,10,10,6,22,0,82,1.203,0,6,22,16,16,0
"DG_s04",56,172.828,173.578,174.922,174.937,10,10,10,18,0,76,1.344,0,10,18,8,8,0
"DG_s04",57,175.937,176.687,177.968,177.968,10,10,13,22,0,82,1.281,0,13,22,9,9,0
"DG_s04",58,178.968,179.718,180.875,180.875,10,10,3,31,0,76,1.157,0,3,31,28,28,0
"DG_s04",59,181.875,182.625,183.656,183.656,26,14,10,10,12,82,1.031,1,26,14,12,0,-12
"DG_s04",60,184.656,185.406,186.562,186.562,18,2,10,10,16,82,1.156,1,18,2,16,0,-16
"DG_s04",61,187.562,188.312,189.953,189.968,16,16,10,10,0,76,1.641,1,16,16,0,0,0
"DG_s04",62,190.968,191.718,192.906,192.906,10,10,8,11,0,76,1.188,0,8,11,3,3,0
"DG_s04",63,193.906,194.656,195.64,195.656,10,10,10,26,0,76,0.984,0,10,26,16,16,0
"DG_s04",64,196.656,197.406,198.39,198.39,10,10,15,30,0,82,0.984,0,15,30,15,15,0
"DG_s04",65,199.39,200.14,201.093,201.093,22,10,10,10,12,76,0.953,1,22,10,12,0,-12
"DG_s04",66,202.093,202.843,204.156,204.156,12,4,10,10,8,76,1.313,1,12,4,8,0,-8
"DG_s04",67,205.172,205.922,207,207.015,26,14,10,10,12,82,1.078,1,26,14,12,0,-12
"DG_s04",68,208.015,208.765,209.89,209.906,22,6,10,10,16,76,1.125,1,22,6,16,0,-16
"DG_s04",69,210.906,211.656,212.765,212.765,10,10,6,22,0,82,1.109,0,6,22,16,16,0
"DG_s04",70,213.765,214.515,215.937,215.953,10,10,8,12,0,76,1.422,0,8,12,4,4,0
"DG_s04",71,216.953,217.703,218.922,218.937,10,10,3,12,0,82,1.219,0,3,12,9,9,0
"DG_s04",72,219.937,220.687,221.922,221.922,18,2,10,10,16,76,1.235,1,18,2,16,0,-16
"DG_s04",73,222.922,223.672,224.531,224.531,22,10,10,10,12,82,0.859,1,22,10,12,0,-12
"DG_s04",74,225.531,226.281,227.984,228,10,10,22,13,0,82,1.703,0,22,13,9,0,-9
"DG_s04",75,229,229.75,231.218,231.218,10,10,8,12,0,76,1.468,0,8,12,4,4,0
"DG_s04",76,232.218,232.968,234.172,234.172,10,10,3,12,0,76,1.204,0,3,12,9,9,0
"DG_s04",77,235.172,235.922,237.172,237.172,10,10,10,18,0,76,1.25,0,10,18,8,8,0
"DG_s04",78,238.187,238.937,240.125,240.125,12,12,10,10,0,76,1.188,1,12,12,0,0,0
"DG_s04",79,241.125,241.875,243.297,243.297,10,10,8,8,0,76,1.422,0,8,8,0,0,0
"DG_s04",80,244.297,245.047,246.25,246.265,28,4,10,10,24,76,1.203,1,28,4,24,0,-24
"DG_s04",81,247.265,248.015,248.984,249,22,6,10,10,16,82,0.969,1,22,6,16,0,-16
"DG_s04",82,250,250.75,251.781,251.781,30,15,10,10,15,76,1.031,1,30,15,15,0,-15
"DG_s04",83,252.781,253.531,254.937,254.953,28,4,10,10,24,76,1.406,1,28,4,24,0,-24
"DG_s04",84,255.953,256.703,257.906,257.906,10,10,4,4,0,76,1.203,0,4,4,0,0,0
"DG_s04",85,258.906,259.656,261.015,261.015,10,10,13,7,0,82,1.359,0,13,7,6,0,-6
"DG_s04",86,262.015,262.765,263.859,263.859,10,10,10,26,0,76,1.094,0,10,26,16,16,0
"DG_s04",87,264.859,265.609,266.843,266.843,10,10,13,22,0,76,1.234,0,13,22,9,9,0
"DG_s04",88,267.843,268.593,270.109,270.109,10,10,16,4,0,82,1.516,0,16,4,12,0,-12
"DG_s04",89,271.109,271.859,273.234,273.234,10,10,8,11,0,76,1.375,0,8,11,3,3,0
"DG_s04",90,274.25,275,276.062,276.062,18,18,10,10,0,76,1.062,1,18,18,0,0,0
"DG_s04",91,277.062,277.812,279.281,279.281,10,10,8,16,0,82,1.469,0,8,16,8,8,0
"DG_s04",92,280.281,281.031,282.078,282.093,10,10,3,17,0,76,1.047,0,3,17,14,14,0
"DG_s04",93,283.093,283.843,284.875,284.875,10,10,6,6,0,76,1.032,0,6,6,0,0,0
"DG_s04",94,285.875,286.625,288.093,288.093,10,10,14,26,0,76,1.468,0,14,26,12,12,0
"DG_s04",95,289.093,289.843,291.359,291.359,10,10,11,7,0,82,1.516,0,11,7,4,0,-4
"DG_s04",96,292.359,293.109,294.453,294.453,16,4,10,10,12,76,1.344,1,16,4,12,0,-12
"DG_s04",97,295.453,296.203,297.453,297.453,13,1,10,10,12,82,1.25,1,13,1,12,0,-12
"DG_s04",98,298.453,299.203,300.656,300.672,11,7,10,10,4,76,1.453,1,11,7,4,0,-4
"DG_s04",99,301.672,302.422,303.375,303.375,10,10,6,11,0,82,0.953,0,6,11,5,5,0
"DG_s04",100,304.375,305.125,306.437,306.437,10,10,15,30,0,82,1.312,0,15,30,15,15,0
"DG_s04",101,307.437,308.187,309.359,309.375,18,10,10,10,8,76,1.172,1,18,10,8,0,-8
"DG_s04",102,310.375,311.125,312.484,312.484,10,10,6,14,0,76,1.359,0,6,14,8,8,0
"DG_s04",103,313.484,314.234,315.359,315.375,10,10,10,22,0,76,1.125,0,10,22,12,12,0
"DG_s04",104,316.375,317.125,318.047,318.062,30,10,10,10,20,82,0.922,1,30,10,20,0,-20
"DG_s04",105,319.062,319.812,321.468,321.468,18,12,10,10,6,76,1.656,1,18,12,6,0,-6
"DG_s04",106,322.468,323.218,324.5,324.5,18,10,10,10,8,76,1.282,1,18,10,8,0,-8
"DG_s04",107,325.5,326.25,327.234,327.234,13,1,10,10,12,82,0.984,1,13,1,12,0,-12
"DG_s04",108,328.234,328.984,330.265,330.281,16,8,10,10,8,76,1.281,1,16,8,8,0,-8
"DG_s04",110,335.031,335.781,337.14,337.14,10,10,22,13,0,76,1.359,0,22,13,9,0,-9
"DG_s04",111,338.14,338.89,340.015,340.031,10,10,8,16,0,76,1.125,0,8,16,8,8,0
"DG_s04",112,341.031,341.781,342.859,342.859,10,10,12,18,0,82,1.078,0,12,18,6,6,0
"DG_s04",113,343.859,344.609,345.578,345.578,12,4,10,10,8,76,0.969,1,12,4,8,0,-8
"DG_s04",114,346.578,347.328,348.25,348.265,10,10,14,26,0,82,0.922,0,14,26,12,12,0
"DG_s04",115,349.265,350.015,351.203,351.203,10,10,10,30,0,76,1.188,0,10,30,20,20,0
"DG_s04",116,352.203,352.953,354.125,354.125,14,14,10,10,0,82,1.172,1,14,14,0,0,0
"DG_s04",117,355.14,355.89,357.062,357.078,10,10,6,14,0,76,1.172,0,6,14,8,8,0
"DG_s04",118,358.078,358.828,359.922,359.922,10,10,6,11,0,76,1.094,0,6,11,5,5,0
"DG_s04",119,360.922,361.672,362.656,362.656,30,15,10,10,15,76,0.984,1,30,15,15,0,-15
"DG_s04",120,363.656,364.406,365.468,365.468,10,10,3,17,0,76,1.062,0,3,17,14,14,0
"DG_s04",121,366.468,367.218,368.5,368.5,10,10,13,7,0,82,1.282,0,13,7,6,0,-6
"DG_s04",122,369.5,370.25,371.922,371.922,12,18,10,10,6,82,1.672,1,12,18,6,6,0
"DG_s04",123,372.937,373.687,374.968,374.984,16,8,10,10,8,76,1.281,1,16,8,8,0,-8
"DG_s04",124,375.984,376.734,377.937,377.937,10,10,10,30,0,76,1.203,0,10,30,20,20,0
"DG_s04",125,378.937,379.687,380.859,380.859,18,12,10,10,6,76,1.172,1,18,12,6,0,-6
"DG_s04",126,381.859,382.609,383.875,383.875,10,10,2,2,0,76,1.266,0,2,2,0,0,0
"DG_s04",127,384.875,385.625,386.734,386.75,10,10,3,31,0,76,1.109,0,3,31,28,28,0
"DG_s04",128,387.75,388.5,389.484,389.484,10,10,10,22,0,82,0.984,0,10,22,12,12,0
"DG_s04",129,390.484,391.234,392.343,392.343,26,10,10,10,16,82,1.109,1,26,10,16,0,-16
"DG_s04",130,393.343,394.093,395.047,395.047,30,10,10,10,20,76,0.954,1,30,10,20,0,-20
"DG_s04",131,396.047,396.797,398.125,398.125,10,10,6,22,0,82,1.328,0,6,22,16,16,0
"DG_s04",132,399.125,399.875,401.343,401.343,10,10,10,18,0,76,1.468,0,10,18,8,8,0
"DG_s04",133,402.343,403.093,404.297,404.297,10,10,13,22,0,82,1.204,0,13,22,9,9,0
"DG_s04",134,405.297,406.047,407.25,407.25,10,10,3,31,0,76,1.203,0,3,31,28,28,0
"DG_s04",135,408.25,409,410.25,410.25,26,14,10,10,12,82,1.25,1,26,14,12,0,-12
"DG_s04",136,411.25,412,413.047,413.047,18,2,10,10,16,82,1.047,1,18,2,16,0,-16
"DG_s04",137,414.047,414.797,416.078,416.093,16,16,10,10,0,76,1.281,1,16,16,0,0,0
"DG_s04",138,417.093,417.843,419.281,419.297,10,10,8,11,0,76,1.438,0,8,11,3,3,0
"DG_s04",139,420.297,421.047,422.265,422.265,10,10,10,26,0,76,1.218,0,10,26,16,16,0
"DG_s04",140,423.281,424.031,425.328,425.328,10,10,15,30,0,82,1.297,0,15,30,15,15,0
"DG_s04",141,426.328,427.078,428.703,428.718,22,10,10,10,12,76,1.625,1,22,10,12,0,-12
"DG_s04",142,429.718,430.468,431.593,431.593,12,4,10,10,8,76,1.125,1,12,4,8,0,-8
"DG_s04",143,432.593,433.343,434.453,434.453,26,14,10,10,12,82,1.11,1,26,14,12,0,-12
"DG_s04",144,435.453,436.203,437.468,437.468,22,6,10,10,16,76,1.265,1,22,6,16,0,-16
"DG_s04",145,438.468,439.218,440.203,440.203,10,10,6,22,0,82,0.985,0,6,22,16,16,0
"DG_s04",146,441.218,441.968,443.406,443.422,10,10,8,12,0,76,1.438,0,8,12,4,4,0
"DG_s04",147,444.422,445.172,446.453,446.453,10,10,3,12,0,82,1.281,0,3,12,9,9,0
"DG_s04",148,447.453,448.203,449.843,449.843,18,2,10,10,16,76,1.64,1,18,2,16,0,-16
"DG_s04",150,454.593,455.343,456.859,456.859,10,10,22,13,0,82,1.516,0,22,13,9,0,-9
"DG_s04",151,457.859,458.609,460.468,460.468,10,10,8,12,0,76,1.859,0,8,12,4,4,0
"DG_s04",152,461.468,462.218,463.859,463.859,10,10,3,12,0,76,1.641,0,3,12,9,9,0
"DG_s04",153,464.859,465.609,467.078,467.093,10,10,10,18,0,76,1.469,0,10,18,8,8,0
"DG_s04",154,468.093,468.843,470.75,470.75,12,12,10,10,0,76,1.907,1,12,12,0,0,0
"DG_s04",155,471.75,472.5,473.906,473.906,10,10,8,8,0,76,1.406,0,8,8,0,0,0
"DG_s04",156,474.906,475.656,476.75,476.765,28,4,10,10,24,76,1.094,1,28,4,24,0,-24
"DG_s04",157,477.765,478.515,480.218,480.218,10,10,22,6,0,76,1.703,0,22,6,16,0,-16
"DG_s04",158,481.234,481.984,483.187,483.187,30,15,10,10,15,76,1.203,1,30,15,15,0,-15
"DG_s04",159,484.187,484.937,486.109,486.125,28,4,10,10,24,76,1.172,1,28,4,24,0,-24
"DG_s04",160,487.125,487.875,489.281,489.281,10,10,4,4,0,76,1.406,0,4,4,0,0,0
"DG_s04",161,490.297,491.047,492.422,492.437,10,10,13,7,0,82,1.375,0,13,7,6,0,-6
"DG_s04",162,493.437,494.187,495.687,495.703,10,10,10,26,0,76,1.5,0,10,26,16,16,0
"DG_s04",163,496.703,497.453,499.078,499.078,10,10,13,22,0,76,1.625,0,13,22,9,9,0
"DG_s04",165,503.828,504.578,506.015,506.015,10,10,8,11,0,76,1.437,0,8,11,3,3,0
"DG_s04",166,507.015,507.765,509.031,509.047,18,18,10,10,0,76,1.266,1,18,18,0,0,0
"DG_s04",167,510.047,510.797,512.297,512.312,10,10,8,16,0,82,1.5,0,8,16,8,8,0
"DG_s04",168,513.312,514.062,515.25,515.25,10,10,3,17,0,76,1.188,0,3,17,14,14,0
"DG_s04",169,516.25,517,518.297,518.297,10,10,6,6,0,76,1.297,0,6,6,0,0,0
"DG_s04",170,519.297,520.047,521.625,521.625,10,10,14,26,0,76,1.578,0,14,26,12,12,0
"DG_s04",171,522.625,523.375,525.328,525.328,10,10,11,7,0,82,1.953,0,11,7,4,0,-4
"DG_s04",172,526.328,527.078,528.593,528.593,16,4,10,10,12,76,1.515,1,16,4,12,0,-12
"DG_s04",173,529.593,530.343,531.562,531.562,10,10,13,1,0,76,1.219,0,13,1,12,0,-12
"DG_s04",174,532.562,533.312,535.078,535.093,11,7,10,10,4,76,1.766,1,11,7,4,0,-4
"DG_s04",175,536.093,536.843,538.125,538.14,10,10,6,11,0,82,1.282,0,6,11,5,5,0
"DG_s04",176,539.14,539.89,541.515,541.531,10,10,15,30,0,82,1.625,0,15,30,15,15,0
"DG_s04",177,542.531,543.281,544.5,544.5,18,10,10,10,8,76,1.219,1,18,10,8,0,-8
"DG_s04",178,545.5,546.25,547.406,547.422,10,10,6,14,0,76,1.156,0,6,14,8,8,0
"DG_s04",179,548.422,549.172,550.547,550.547,10,10,10,22,0,76,1.375,0,10,22,12,12,0
"DG_s04",180,551.547,552.297,553.265,553.265,30,10,10,10,20,82,0.968,1,30,10,20,0,-20
"DG_s04",181,554.281,555.031,556.828,556.828,18,12,10,10,6,76,1.797,1,18,12,6,0,-6
"DG_s04",182,557.828,558.578,559.687,559.687,18,10,10,10,8,76,1.109,1,18,10,8,0,-8
"DG_s04",183,560.687,561.437,562.593,562.593,13,1,10,10,12,82,1.156,1,13,1,12,0,-12
"DG_s04",184,563.593,564.343,565.515,565.515,16,8,10,10,8,76,1.172,1,16,8,8,0,-8
"DG_s04",185,566.515,567.265,568.625,568.625,26,10,10,10,16,76,1.36,1,26,10,16,0,-16
"DG_s04",187,573.39,574.14,575.672,575.672,10,10,8,16,0,76,1.532,0,8,16,8,8,0
"DG_s04",189,580.422,581.172,582.187,582.187,12,4,10,10,8,76,1.015,1,12,4,8,0,-8
"DG_s04",190,583.187,583.937,585.203,585.203,10,10,14,26,0,82,1.266,0,14,26,12,12,0
"DG_s04",191,586.203,586.953,588.343,588.359,10,10,10,30,0,76,1.39,0,10,30,20,20,0
"DG_s04",192,589.359,590.109,591.437,591.437,14,14,10,10,0,82,1.328,1,14,14,0,0,0
"DG_s04",193,592.437,593.187,594.406,594.422,10,10,6,14,0,76,1.219,0,6,14,8,8,0
"DG_s04",194,595.422,596.172,597.453,597.468,10,10,6,11,0,76,1.281,0,6,11,5,5,0
"DG_s04",195,598.468,599.218,600.14,600.14,30,15,10,10,15,76,0.922,1,30,15,15,0,-15
"DG_s04",196,601.14,601.89,603.172,603.172,10,10,3,17,0,76,1.282,0,3,17,14,14,0
"DG_s04",197,604.172,604.922,606.218,606.218,10,10,13,7,0,82,1.296,0,13,7,6,0,-6
"DG_s04",198,607.218,607.968,609.297,609.297,10,10,12,18,0,76,1.329,0,12,18,6,6,0
"DG_s04",199,610.312,611.062,612.172,612.172,16,8,10,10,8,76,1.11,1,16,8,8,0,-8
"DG_s04",200,613.172,613.922,615.89,615.89,10,10,10,30,0,76,1.968,0,10,30,20,20,0
"DG_s05",5,22.203,22.937,25.343,25.343,10,10,22,6,0,76,2.406,0,22,6,16,0,-16
"DG_s05",6,26.343,27.078,28.937,28.937,10,10,30,15,0,82,1.859,0,30,15,15,0,-15
"DG_s05",7,29.937,30.672,33.672,33.672,10,10,28,4,0,82,3,0,28,4,24,0,-24
"DG_s05",9,40.406,41.14,42.843,42.843,10,10,13,7,0,82,1.703,0,13,7,6,0,-6
"DG_s05",10,43.843,44.578,47.109,47.109,10,10,10,26,0,76,2.531,0,10,26,16,16,0
"DG_s05",11,48.109,48.843,50.609,50.609,10,10,13,22,0,76,1.766,0,13,22,9,9,0
"DG_s05",12,51.609,52.343,55.375,55.375,10,10,16,4,0,82,3.032,0,16,4,12,0,-12
"DG_s05",13,56.375,57.109,59.5,59.5,10,10,8,11,0,76,2.391,0,8,11,3,3,0
"DG_s05",15,66.234,66.968,69.265,69.281,10,10,8,16,0,82,2.297,0,8,16,8,8,0
"DG_s05",18,81.75,82.484,85.968,85.968,10,10,14,26,0,76,3.484,0,14,26,12,12,0
"DG_s05",19,86.968,87.703,89.172,89.172,10,10,11,7,0,82,1.469,0,11,7,4,0,-4
"DG_s05",20,90.187,90.922,92.593,92.609,10,10,16,4,0,82,1.671,0,16,4,12,0,-12
"DG_s05",21,93.609,94.343,96.047,96.047,10,10,13,1,0,76,1.704,0,13,1,12,0,-12
"DG_s05",22,97.047,97.781,100.515,100.515,10,10,11,7,0,82,2.734,0,11,7,4,0,-4
"DG_s05",23,101.531,102.265,103.953,103.953,10,10,6,11,0,82,1.688,0,6,11,5,5,0
"DG_s05",24,104.953,105.687,107.25,107.265,10,10,15,30,0,82,1.563,0,15,30,15,15,0
"DG_s05",25,108.265,109,111.453,111.453,10,10,18,10,0,82,2.453,0,18,10,8,0,-8
"DG_s05",26,112.453,113.187,115.109,115.109,10,10,6,14,0,76,1.922,0,6,14,8,8,0
"DG_s05",27,116.109,116.843,118.718,118.718,10,10,10,22,0,76,1.875,0,10,22,12,12,0
"DG_s05",28,119.718,120.453,122.578,122.578,10,10,30,10,0,76,2.125,0,30,10,20,0,-20
"DG_s05",29,123.578,124.312,126.89,126.89,10,10,18,12,0,82,2.578,0,18,12,6,0,-6
"DG_s05",30,127.89,128.625,131.031,131.047,10,10,18,10,0,82,2.406,0,18,10,8,0,-8
"DG_s05",31,132.047,132.781,134.531,134.531,10,10,13,1,0,76,1.75,0,13,1,12,0,-12
"DG_s05",32,135.547,136.281,138.422,138.422,10,10,16,8,0,82,2.141,0,16,8,8,0,-8
"DG_s05",33,139.422,140.156,141.75,141.75,10,10,26,10,0,82,1.594,0,26,10,16,0,-16
"DG_s05",34,142.75,143.484,145.672,145.672,10,10,22,13,0,76,2.188,0,22,13,9,0,-9
"DG_s05",35,146.672,147.406,149.031,149.047,8,16,10,10,8,82,1.625,1,8,16,8,8,0
"DG_s05",36,150.047,150.781,152.797,152.797,10,10,12,18,0,82,2.016,0,12,18,6,6,0
"DG_s05",37,153.797,154.531,156.125,156.125,10,10,12,4,0,82,1.594,0,12,4,8,0,-8
"DG_s05",38,157.125,157.859,160.093,160.093,10,10,14,26,0,82,2.234,0,14,26,12,12,0
"DG_s05",39,161.093,161.828,163.156,163.156,10,10,10,30,0,76,1.328,0,10,30,20,20,0
"DG_s05",40,164.156,164.89,167.406,167.406,14,14,10,10,0,82,2.516,1,14,14,0,0,0
"DG_s05",41,168.406,169.14,172.703,172.703,10,10,6,14,0,76,3.563,0,6,14,8,8,0
"DG_s05",42,173.703,174.437,176.14,176.14,10,10,6,11,0,76,1.703,0,6,11,5,5,0
"DG_s05",43,177.14,177.875,179.687,179.703,10,10,30,15,0,82,1.812,0,30,15,15,0,-15
"DG_s05",44,180.703,181.437,183.703,183.703,10,10,3,17,0,76,2.266,0,3,17,14,14,0
"DG_s05",45,184.703,185.437,188,188.015,10,10,13,7,0,82,2.563,0,13,7,6,0,-6
"DG_s05",46,189.015,189.75,191.437,191.437,10,10,12,18,0,76,1.687,0,12,18,6,6,0
"DG_s05",47,192.437,193.172,194.484,194.484,10,10,16,8,0,82,1.312,0,16,8,8,0,-8
"DG_s05",48,195.484,196.218,197.797,197.797,10,10,10,30,0,76,1.579,0,10,30,20,20,0
"DG_s05",49,198.797,199.531,202.078,202.078,10,10,18,12,0,82,2.547,0,18,12,6,0,-6
"DG_s05",51,208.812,209.547,211,211.015,10,10,3,31,0,76,1.453,0,3,31,28,28,0
"DG_s05",52,212.015,212.75,215.093,215.093,10,10,10,22,0,82,2.343,0,10,22,12,12,0
"DG_s05",53,216.093,216.828,218.765,218.765,10,10,26,10,0,76,1.937,0,26,10,16,0,-16
"DG_s05",54,219.765,220.5,222.312,222.312,10,10,30,10,0,82,1.812,0,30,10,20,0,-20
"DG_s05",55,223.312,224.047,226.125,226.125,10,10,6,22,0,82,2.078,0,6,22,16,16,0
"DG_s05",56,227.125,227.859,229.453,229.453,10,10,10,18,0,76,1.594,0,10,18,8,8,0
"DG_s05",57,230.453,231.187,233.14,233.14,10,10,13,22,0,82,1.953,0,13,22,9,9,0
"DG_s05",58,234.14,234.875,235.89,235.89,10,10,3,31,0,76,1.015,0,3,31,28,28,0
"DG_s05",59,236.906,237.64,239.172,239.172,10,10,26,14,0,76,1.532,0,26,14,12,0,-12
"DG_s05",60,240.172,240.906,242.593,242.609,10,10,18,2,0,76,1.687,0,18,2,16,0,-16
"DG_s05",61,243.609,244.343,245.812,245.812,10,10,16,16,0,82,1.469,0,16,16,0,0,0
"DG_s05",62,246.812,247.547,249.265,249.265,10,10,8,11,0,76,1.718,0,8,11,3,3,0
"DG_s05",63,250.265,251,252.765,252.765,10,10,10,26,0,76,1.765,0,10,26,16,16,0
"DG_s05",64,253.765,254.5,255.765,255.765,10,10,15,30,0,82,1.265,0,15,30,15,15,0
"DG_s05",65,256.765,257.5,259.062,259.062,10,10,22,10,0,82,1.562,0,22,10,12,0,-12
"DG_s05",66,260.062,260.797,262.531,262.531,10,10,12,4,0,82,1.734,0,12,4,8,0,-8
"DG_s05",67,263.547,264.281,266.531,266.531,10,10,26,14,0,76,2.25,0,26,14,12,0,-12
"DG_s05",68,267.547,268.281,272.172,272.172,10,10,22,6,0,82,3.891,0,22,6,16,0,-16
"DG_s05",69,273.187,273.922,275.89,275.89,10,10,6,22,0,82,1.968,0,6,22,16,16,0
"DG_s05",70,276.89,277.625,279.047,279.047,10,10,8,12,0,76,1.422,0,8,12,4,4,0
"DG_s05",71,280.047,280.781,282.484,282.484,10,10,3,12,0,82,1.703,0,3,12,9,9,0
"DG_s05",72,283.484,284.218,286.203,286.203,10,10,18,2,0,82,1.985,0,18,2,16,0,-16
"DG_s05",73,287.203,287.937,290.14,290.14,10,10,22,10,0,76,2.203,0,22,10,12,0,-12
"DG_s05",74,291.14,291.875,293.297,293.312,10,10,22,13,0,82,1.422,0,22,13,9,0,-9
"DG_s05",75,294.312,295.047,295.781,295.781,10,10,8,12,0,76,0.734,0,8,12,4,4,0
"DG_s05",76,296.781,297.515,298.562,298.562,10,10,3,12,0,76,1.047,0,3,12,9,9,0
"DG_s05",77,299.578,300.312,302.5,302.5,10,10,10,18,0,76,2.188,0,10,18,8,8,0
"DG_s05",80,314.984,315.718,318.203,318.203,10,10,28,4,0,82,2.485,0,28,4,24,0,-24
"DG_s05",81,319.203,319.937,322.328,322.328,10,10,22,6,0,76,2.391,0,22,6,16,0,-16
"DG_s05",82,323.328,324.062,325.765,325.765,10,10,30,15,0,82,1.703,0,30,15,15,0,-15
"DG_s05",83,326.765,327.5,329.297,329.297,10,10,28,4,0,82,1.797,0,28,4,24,0,-24
"DG_s05",85,336.031,336.765,338.547,338.547,10,10,13,7,0,82,1.782,0,13,7,6,0,-6
"DG_s05",86,339.562,340.297,342.234,342.234,10,10,10,26,0,76,1.937,0,10,26,16,16,0
"DG_s05",87,343.234,343.968,346.093,346.093,10,10,13,22,0,76,2.125,0,13,22,9,9,0
"DG_s05",88,347.093,347.828,349.593,349.593,10,10,16,4,0,82,1.765,0,16,4,12,0,-12
"DG_s05",89,350.593,351.328,353.39,353.406,10,10,8,11,0,76,2.062,0,8,11,3,3,0
"DG_s05",91,360.14,360.875,362.672,362.672,10,10,8,16,0,82,1.797,0,8,16,8,8,0
"DG_s05",92,363.672,364.406,366.39,366.406,10,10,3,17,0,76,1.984,0,3,17,14,14,0
"DG_s05",94,373.14,373.875,375.203,375.203,10,10,14,26,0,76,1.328,0,14,26,12,12,0
"DG_s05",95,376.218,376.953,378.765,378.765,10,10,11,7,0,82,1.812,0,11,7,4,0,-4
"DG_s05",96,379.765,380.5,382.093,382.093,10,10,16,4,0,82,1.593,0,16,4,12,0,-12
"DG_s05",97,383.093,383.828,385.609,385.609,10,10,13,1,0,76,1.781,0,13,1,12,0,-12
"DG_s05",98,386.609,387.343,389.515,389.515,10,10,11,7,0,82,2.172,0,11,7,4,0,-4
"DG_s05",99,390.515,391.25,392.797,392.797,10,10,6,11,0,82,1.547,0,6,11,5,5,0
"DG_s05",100,393.797,394.531,396.218,396.218,10,10,15,30,0,82,1.687,0,15,30,15,15,0
"DG_s05",101,397.234,397.968,400.203,400.203,10,10,18,10,0,82,2.235,0,18,10,8,0,-8
"DG_s05",102,401.218,401.953,403.718,403.734,10,10,6,14,0,76,1.765,0,6,14,8,8,0
"DG_s05",103,404.734,405.468,407.812,407.812,10,10,10,22,0,76,2.344,0,10,22,12,12,0
"DG_s05",104,408.812,409.547,411.468,411.468,10,10,30,10,0,76,1.921,0,30,10,20,0,-20
"DG_s05",105,412.468,413.203,414.875,414.875,10,10,18,12,0,82,1.672,0,18,12,6,0,-6
"DG_s05",106,415.89,416.625,418.547,418.547,10,10,18,10,0,82,1.922,0,18,10,8,0,-8
"DG_s05",107,419.547,420.281,422.531,422.531,10,10,13,1,0,76,2.25,0,13,1,12,0,-12
"DG_s05",108,423.547,424.281,425.953,425.968,10,10,16,8,0,82,1.672,0,16,8,8,0,-8
"DG_s05",109,426.968,427.703,429.39,429.39,10,10,26,10,0,82,1.687,0,26,10,16,0,-16
"DG_s05",110,430.39,431.125,432.328,432.328,22,13,10,10,9,82,1.203,1,22,13,9,0,-9
"DG_s05",111,433.328,434.062,436.609,436.609,10,10,8,16,0,76,2.547,0,8,16,8,8,0
"DG_s05",112,437.609,438.343,439.765,439.765,10,10,12,18,0,82,1.422,0,12,18,6,6,0
"DG_s05",113,440.765,441.5,444.281,444.297,10,10,12,4,0,82,2.781,0,12,4,8,0,-8
"DG_s05",114,445.297,446.031,448.422,448.437,10,10,14,26,0,82,2.391,0,14,26,12,12,0
"DG_s05",115,449.437,450.172,451.937,451.937,10,10,10,30,0,76,1.765,0,10,30,20,20,0
"DG_s05",116,452.937,453.672,457.172,457.172,10,10,14,14,0,76,3.5,0,14,14,0,0,0
"DG_s05",118,463.906,464.64,466.812,466.812,10,10,6,11,0,76,2.172,0,6,11,5,5,0
"DG_s05",119,467.812,468.547,471.406,471.406,10,10,30,15,0,82,2.859,0,30,15,15,0,-15
"DG_s05",121,478.14,478.875,480.281,480.281,10,10,13,7,0,82,1.406,0,13,7,6,0,-6
"DG_s05",122,481.281,482.015,484.359,484.359,10,10,12,18,0,76,2.344,0,12,18,6,6,0
"DG_s05",123,485.359,486.093,488.062,488.062,10,10,16,8,0,82,1.969,0,16,8,8,0,-8
"DG_s05",124,489.062,489.797,491.297,491.297,10,10,10,30,0,76,1.5,0,10,30,20,20,0
"DG_s05",125,492.297,493.031,495.672,495.672,10,10,18,12,0,82,2.641,0,18,12,6,0,-6
"DG_s05",127,502.406,503.14,504.968,504.984,10,10,3,31,0,76,1.828,0,3,31,28,28,0
"DG_s05",128,505.984,506.718,508.109,508.109,10,10,10,22,0,82,1.391,0,10,22,12,12,0
"DG_s05",129,509.109,509.843,511.547,511.547,10,10,26,10,0,76,1.704,0,26,10,16,0,-16
"DG_s05",130,512.562,513.297,515.5,515.5,10,10,30,10,0,82,2.203,0,30,10,20,0,-20
"DG_s05",131,516.5,517.234,519.015,519.031,10,10,6,22,0,82,1.781,0,6,22,16,16,0
"DG_s05",132,520.031,520.765,523.203,523.203,10,10,10,18,0,76,2.438,0,10,18,8,8,0
"DG_s05",133,524.218,524.953,526.531,526.531,10,10,13,22,0,82,1.578,0,13,22,9,9,0
"DG_s05",134,527.547,528.281,529.718,529.734,10,10,3,31,0,76,1.437,0,3,31,28,28,0
"DG_s05",135,530.734,531.468,533.375,533.39,10,10,26,14,0,76,1.907,0,26,14,12,0,-12
"DG_s05",136,534.39,535.125,536.843,536.843,10,10,18,2,0,76,1.718,0,18,2,16,0,-16
"DG_s05",137,537.843,538.578,540.39,540.406,10,10,16,16,0,82,1.812,0,16,16,0,0,0
"DG_s05",139,547.14,547.875,549.656,549.656,10,10,10,26,0,76,1.781,0,10,26,16,16,0
"DG_s05",140,550.656,551.39,553.031,553.047,10,10,15,30,0,82,1.641,0,15,30,15,15,0
"DG_s05",141,554.047,554.781,556.312,556.328,10,10,22,10,0,82,1.531,0,22,10,12,0,-12
"DG_s05",142,557.328,558.062,560.156,560.156,10,10,12,4,0,82,2.094,0,12,4,8,0,-8
"DG_s05",143,561.156,561.89,564.093,564.109,26,14,10,10,12,82,2.203,1,26,14,12,0,-12
"DG_s05",146,576.578,577.312,578.672,578.687,8,12,10,10,4,82,1.36,1,8,12,4,4,0
"DG_s05",147,579.687,580.422,581.937,581.937,10,10,3,12,0,82,1.515,0,3,12,9,9,0
"DG_s05",148,582.953,583.687,585.453,585.453,10,10,18,2,0,82,1.766,0,18,2,16,0,-16
"DG_s05",149,586.453,587.187,589.734,589.734,10,10,22,10,0,76,2.547,0,22,10,12,0,-12
"DG_s05",150,590.734,591.468,593.109,593.125,10,10,22,13,0,82,1.641,0,22,13,9,0,-9
"DG_s05",151,594.125,594.859,596.156,596.156,10,10,8,12,0,76,1.297,0,8,12,4,4,0
"DG_s05",152,597.156,597.89,600.562,600.562,10,10,3,12,0,76,2.672,0,3,12,9,9,0
"DG_s05",153,601.562,602.297,604.265,604.265,10,10,10,18,0,76,1.968,0,10,18,8,8,0
"DG_s05",156,616.75,617.484,619.203,619.203,10,10,28,4,0,82,1.719,0,28,4,24,0,-24
"DG_s05",157,620.203,620.937,622.297,622.312,10,10,22,6,0,76,1.36,0,22,6,16,0,-16
"DG_s05",158,623.312,624.047,625.64,625.656,10,10,30,15,0,82,1.593,0,30,15,15,0,-15
"DG_s05",159,626.656,627.39,629.718,629.734,10,10,28,4,0,82,2.328,0,28,4,24,0,-24
"DG_s05",161,636.468,637.203,638.468,638.468,10,10,13,7,0,82,1.265,0,13,7,6,0,-6
"DG_s05",162,639.468,640.203,641.718,641.734,10,10,10,26,0,76,1.515,0,10,26,16,16,0
"DG_s05",163,642.734,643.468,645.359,645.375,10,10,13,22,0,76,1.891,0,13,22,9,9,0
"DG_s05",164,646.375,647.109,648.5,648.5,10,10,16,4,0,82,1.391,0,16,4,12,0,-12
"DG_s05",165,649.5,650.234,652.781,652.781,10,10,8,11,0,76,2.547,0,8,11,3,3,0
"DG_s05",166,653.781,654.515,656.718,656.718,18,18,10,10,0,76,2.203,1,18,18,0,0,0
"DG_s05",167,657.718,658.453,660.062,660.078,10,10,8,16,0,82,1.609,0,8,16,8,8,0
"DG_s05",168,661.078,661.812,663.515,663.515,10,10,3,17,0,76,1.703,0,3,17,14,14,0
"DG_s05",170,670.25,670.984,672.515,672.515,10,10,14,26,0,76,1.531,0,14,26,12,12,0
"DG_s05",171,673.515,674.25,676.156,676.156,10,10,11,7,0,82,1.906,0,11,7,4,0,-4
"DG_s05",172,677.156,677.89,680.906,680.906,10,10,16,4,0,82,3.016,0,16,4,12,0,-12
"DG_s05",173,681.906,682.64,684.515,684.515,10,10,13,1,0,76,1.875,0,13,1,12,0,-12
"DG_s05",174,685.515,686.25,688.89,688.89,10,10,11,7,0,82,2.64,0,11,7,4,0,-4
"DG_s05",175,689.89,690.625,691.312,691.312,10,10,6,11,0,82,0.687,0,6,11,5,5,0
"DG_s05",176,692.328,693.062,694.859,694.859,10,10,15,30,0,82,1.797,0,15,30,15,15,0
"DG_s05",177,695.859,696.593,698.531,698.531,10,10,18,10,0,82,1.938,0,18,10,8,0,-8
"DG_s05",178,699.531,700.265,703.765,703.781,10,10,6,14,0,76,3.5,0,6,14,8,8,0
"DG_s05",179,704.781,705.515,707.812,707.812,10,10,10,22,0,76,2.297,0,10,22,12,12,0
"DG_s05",180,708.812,709.547,713.312,713.328,10,10,30,10,0,76,3.765,0,30,10,20,0,-20
"DG_s05",181,714.328,715.062,717.281,717.281,10,10,18,12,0,82,2.219,0,18,12,6,0,-6
"DG_s05",183,724.015,724.75,725.234,725.234,13,1,10,10,12,82,0.484,1,13,1,12,0,-12
"DG_s05",185,731.968,732.703,733.922,733.922,10,10,26,10,0,82,1.219,0,26,10,16,0,-16
"DG_s05",187,740.656,741.39,744,744.015,10,10,8,16,0,76,2.61,0,8,16,8,8,0
"DG_s05",188,745.015,745.75,747.687,747.703,10,10,12,18,0,82,1.937,0,12,18,6,6,0
"DG_s05",190,754.437,755.172,756.015,756.015,10,10,14,26,0,82,0.843,0,14,26,12,12,0
"DG_s05",191,757.015,757.75,759.265,759.265,10,10,10,30,0,76,1.515,0,10,30,20,20,0
"DG_s05",193,766.015,766.75,770.562,770.562,6,14,10,10,8,82,3.812,1,6,14,8,8,0
"DG_s05",194,771.562,772.297,773.843,773.843,10,10,6,11,0,76,1.546,0,6,11,5,5,0
"DG_s05",195,774.843,775.578,777.89,777.89,10,10,30,15,0,82,2.312,0,30,15,15,0,-15
"DG_s05",196,778.89,779.625,781.125,781.14,10,10,3,17,0,76,1.5,0,3,17,14,14,0
"DG_s05",197,782.14,782.875,784.172,784.172,10,10,13,7,0,82,1.297,0,13,7,6,0,-6
"DG_s05",198,785.172,785.906,787.468,787.468,10,10,12,18,0,76,1.562,0,12,18,6,6,0
"DG_s05",200,794.203,794.937,795.968,795.968,10,10,10,30,0,76,1.031,0,10,30,20,20,0
"DG_s05",201,796.984,797.718,798.953,798.953,10,10,18,12,0,82,1.235,0,18,12,6,0,-6
"DG_s05",203,805.703,806.437,808.109,808.125,10,10,3,31,0,76,1.672,0,3,31,28,28,0
"DG_s05",204,809.125,809.859,811.484,811.484,10,10,10,22,0,82,1.625,0,10,22,12,12,0
"DG_s05",205,812.484,813.218,816.781,816.781,10,10,26,10,0,76,3.563,0,26,10,16,0,-16
"DG_s05",206,817.781,818.515,821.656,821.656,10,10,30,10,0,82,3.141,0,30,10,20,0,-20
"DG_s05",208,828.406,829.14,830.609,830.609,10,10,10,18,0,76,1.469,0,10,18,8,8,0
"DG_s05",210,837.359,838.093,839,839,10,10,3,31,0,76,0.907,0,3,31,28,28,0
"DG_s05",211,840.015,840.75,841.812,841.812,10,10,26,14,0,76,1.062,0,26,14,12,0,-12
"DG_s05",212,842.812,843.547,845.672,845.672,10,10,18,2,0,76,2.125,0,18,2,16,0,-16
"DG_s05",214,852.422,853.156,855.265,855.265,10,10,8,11,0,76,2.109,0,8,11,3,3,0
"DG_s05",215,856.265,857,859.281,859.281,10,10,10,26,0,76,2.281,0,10,26,16,16,0
"DG_s05",216,860.297,861.031,862.843,862.843,10,10,15,30,0,82,1.812,0,15,30,15,15,0
"DG_s05",217,863.843,864.578,867.187,867.187,10,10,22,10,0,82,2.609,0,22,10,12,0,-12
"DG_s05",218,868.187,868.922,871.031,871.031,10,10,12,4,0,82,2.109,0,12,4,8,0,-8
"DG_s05",219,872.031,872.765,875.687,875.687,10,10,26,14,0,76,2.922,0,26,14,12,0,-12
"DG_s05",221,882.422,883.156,885.187,885.187,10,10,6,22,0,82,2.031,0,6,22,16,16,0
"DG_s05",223,891.922,892.656,894.781,894.797,10,10,3,12,0,82,2.125,0,3,12,9,9,0
"DG_s05",225,901.531,902.265,903.406,903.422,10,10,22,10,0,76,1.141,0,22,10,12,0,-12
"DG_s05",227,910.156,910.89,914.328,914.328,10,10,8,12,0,76,3.438,0,8,12,4,4,0
"DG_s05",228,915.328,916.062,917.187,917.187,10,10,3,12,0,76,1.125,0,3,12,9,9,0
"DG_s06",2,5,5.703,9.531,9.531,12,12,10,10,0,76,3.828,1,12,12,0,0,0
"DG_s06",3,10.531,11.235,13.188,13.188,10,10,8,8,0,76,1.953,0,8,8,0,0,0
"DG_s06",4,14.188,14.891,16.531,16.531,28,4,10,10,24,76,1.64,1,28,4,24,0,-24
"DG_s06",5,17.531,18.235,19.25,19.25,22,6,10,10,16,82,1.015,1,22,6,16,0,-16
"DG_s06",6,20.25,20.953,22.453,22.453,30,15,10,10,15,76,1.5,1,30,15,15,0,-15
"DG_s06",7,23.453,24.156,25.125,25.141,10,10,28,4,0,82,0.969,0,28,4,24,0,-24
"DG_s06",8,26.141,26.844,28.36,28.36,4,4,10,10,0,82,1.516,1,4,4,0,0,0
"DG_s06",9,29.36,30.063,31.797,31.797,10,10,13,7,0,82,1.734,0,13,7,6,0,-6
"DG_s06",10,32.797,33.5,35.516,35.516,10,26,10,10,16,82,2.016,1,10,26,16,16,0
"DG_s06",11,36.516,37.219,39.297,39.297,13,22,10,10,9,82,2.078,1,13,22,9,9,0
"DG_s06",12,40.297,41,42.844,42.844,16,4,10,10,12,76,1.844,1,16,4,12,0,-12
"DG_s06",13,43.844,44.547,46.641,46.641,8,11,10,10,3,82,2.094,1,8,11,3,3,0
"DG_s06",14,47.656,48.36,50.594,50.594,10,10,18,18,0,82,2.234,0,18,18,0,0,0
"DG_s06",15,51.61,52.313,55,55,10,10,8,16,0,82,2.687,0,8,16,8,8,0
"DG_s06",16,56.016,56.719,58.391,58.391,10,10,3,17,0,76,1.672,0,3,17,14,14,0
"DG_s06",17,59.391,60.094,62.391,62.391,10,10,6,6,0,76,2.297,0,6,6,0,0,0
"DG_s06",18,63.391,64.094,66.86,66.86,10,10,14,26,0,76,2.766,0,14,26,12,12,0
"DG_s06",19,67.86,68.563,70.922,70.922,11,7,10,10,4,76,2.359,1,11,7,4,0,-4
"DG_s06",20,71.938,72.641,76.031,76.031,16,4,10,10,12,76,3.39,1,16,4,12,0,-12
"DG_s06",21,77.031,77.735,80.156,80.156,13,1,10,10,12,82,2.421,1,13,1,12,0,-12
"DG_s06",22,81.156,81.86,84.219,84.219,11,7,10,10,4,76,2.359,1,11,7,4,0,-4
"DG_s06",23,85.219,85.922,87.422,87.422,10,10,6,11,0,82,1.5,0,6,11,5,5,0
"DG_s06",24,88.422,89.125,90.5,90.516,15,30,10,10,15,76,1.375,1,15,30,15,15,0
"DG_s06",25,91.516,92.219,93.922,93.922,18,10,10,10,8,76,1.703,1,18,10,8,0,-8
"DG_s06",26,94.922,95.625,97.203,97.203,6,14,10,10,8,82,1.578,1,6,14,8,8,0
"DG_s06",27,98.203,98.906,101.75,101.75,10,10,10,22,0,76,2.844,0,10,22,12,12,0
"DG_s06",28,102.75,103.453,105.438,105.438,30,10,10,10,20,82,1.985,1,30,10,20,0,-20
"DG_s06",29,106.438,107.141,109,109,18,12,10,10,6,76,1.859,1,18,12,6,0,-6
"DG_s06",30,110,110.703,112.328,112.328,18,10,10,10,8,76,1.625,1,18,10,8,0,-8
"DG_s06",31,113.344,114.047,115.594,115.594,13,1,10,10,12,82,1.547,1,13,1,12,0,-12
"DG_s06",32,116.594,117.297,120.391,120.406,16,8,10,10,8,76,3.094,1,16,8,8,0,-8
"DG_s06",33,121.406,122.11,124.891,124.891,26,10,10,10,16,76,2.781,1,26,10,16,0,-16
"DG_s06",34,125.891,126.594,129.266,129.266,22,13,10,10,9,82,2.672,1,22,13,9,0,-9
"DG_s06",35,130.266,130.969,133.703,133.703,10,10,8,16,0,76,2.734,0,8,16,8,8,0
"DG_s06",36,134.703,135.406,137.563,137.563,10,10,12,18,0,82,2.157,0,12,18,6,6,0
"DG_s06",37,138.563,139.266,140.047,140.063,12,4,10,10,8,76,0.781,1,12,4,8,0,-8
"DG_s06",38,141.063,141.766,143.735,143.75,10,10,14,26,0,82,1.969,0,14,26,12,12,0
"DG_s06",39,144.75,145.453,147.61,147.61,10,10,10,30,0,76,2.157,0,10,30,20,20,0
"DG_s06",40,148.61,149.313,151.391,151.406,14,14,10,10,0,82,2.078,1,14,14,0,0,0
"DG_s06",41,152.406,153.11,154.672,154.672,10,10,6,14,0,76,1.562,0,6,14,8,8,0
"DG_s06",42,155.672,156.375,157.969,157.969,10,10,6,11,0,76,1.594,0,6,11,5,5,0
"DG_s06",43,158.985,159.688,161.047,161.063,30,15,10,10,15,76,1.359,1,30,15,15,0,-15
"DG_s06",44,162.063,162.766,165.25,165.25,10,10,3,17,0,76,2.484,0,3,17,14,14,0
"DG_s06",45,166.25,166.953,168.969,168.969,13,7,10,10,6,76,2.016,1,13,7,6,0,-6
"DG_s06",46,169.985,170.688,173.156,173.172,12,18,10,10,6,82,2.468,1,12,18,6,6,0
"DG_s06",47,174.172,174.875,176.86,176.86,16,8,10,10,8,76,1.985,1,16,8,8,0,-8
"DG_s06",48,177.86,178.563,179.61,179.61,10,30,10,10,20,82,1.047,1,10,30,20,20,0
"DG_s06",49,180.61,181.313,183.375,183.375,18,12,10,10,6,76,2.062,1,18,12,6,0,-6
"DG_s06",50,184.375,185.078,187.375,187.375,10,10,2,2,0,76,2.297,0,2,2,0,0,0
"DG_s06",51,188.391,189.094,190.344,190.344,10,10,3,31,0,76,1.25,0,3,31,28,28,0
"DG_s06",52,191.36,192.063,194.047,194.047,10,10,10,22,0,82,1.984,0,10,22,12,12,0
"DG_s06",53,195.063,195.766,197.485,197.5,26,10,10,10,16,82,1.719,1,26,10,16,0,-16
"DG_s06",54,198.5,199.203,200.297,200.297,30,10,10,10,20,76,1.094,1,30,10,20,0,-20
"DG_s06",55,201.297,202,203.86,203.875,10,10,6,22,0,82,1.86,0,6,22,16,16,0
"DG_s06",56,204.875,205.578,207.5,207.5,10,10,10,18,0,76,1.922,0,10,18,8,8,0
"DG_s06",57,208.5,209.203,210.969,210.969,10,10,13,22,0,82,1.766,0,13,22,9,9,0
"DG_s06",58,211.969,212.672,214.5,214.516,10,10,3,31,0,76,1.828,0,3,31,28,28,0
"DG_s06",59,215.516,216.219,218.344,218.344,26,14,10,10,12,82,2.125,1,26,14,12,0,-12
"DG_s06",60,219.36,220.063,221.797,221.813,10,10,18,2,0,76,1.734,0,18,2,16,0,-16
"DG_s06",61,222.813,223.516,225.36,225.36,10,10,16,16,0,82,1.844,0,16,16,0,0,0
"DG_s06",62,226.375,227.078,228.61,228.61,10,10,8,11,0,76,1.532,0,8,11,3,3,0
"DG_s06",63,229.61,230.313,233.781,233.781,10,10,10,26,0,76,3.468,0,10,26,16,16,0
"DG_s06",64,234.781,235.485,237.844,237.844,10,10,15,30,0,82,2.359,0,15,30,15,15,0
"DG_s06",65,238.844,239.547,240.485,240.5,22,10,10,10,12,76,0.938,1,22,10,12,0,-12
"DG_s06",66,241.5,242.203,243.656,243.656,12,4,10,10,8,76,1.453,1,12,4,8,0,-8
"DG_s06",67,244.656,245.36,247.672,247.672,26,14,10,10,12,82,2.312,1,26,14,12,0,-12
"DG_s06",68,248.672,249.375,251.438,251.438,22,6,10,10,16,76,2.063,1,22,6,16,0,-16
"DG_s06",69,252.438,253.141,255.563,255.563,10,10,6,22,0,82,2.422,0,6,22,16,16,0
"DG_s06",70,256.563,257.266,259.625,259.625,10,10,8,12,0,76,2.359,0,8,12,4,4,0
"DG_s06",71,260.625,261.328,262.172,262.172,10,10,3,12,0,82,0.844,0,3,12,9,9,0
"DG_s06",72,263.172,263.875,265.172,265.172,18,2,10,10,16,76,1.297,1,18,2,16,0,-16
"DG_s06",73,266.172,266.875,269.172,269.188,22,10,10,10,12,82,2.297,1,22,10,12,0,-12
"DG_s06",74,270.188,270.891,272.313,272.313,22,13,10,10,9,76,1.422,1,22,13,9,0,-9
"DG_s06",75,273.313,274.016,275.453,275.453,10,10,8,12,0,76,1.437,0,8,12,4,4,0
"DG_s06",76,276.453,277.156,278.656,278.656,10,10,3,12,0,76,1.5,0,3,12,9,9,0
"DG_s06",77,279.656,280.36,281.86,281.86,10,10,10,18,0,76,1.5,0,10,18,8,8,0
"DG_s06",78,282.86,283.563,285.422,285.422,12,12,10,10,0,76,1.859,1,12,12,0,0,0
"DG_s06",79,286.422,287.125,288.797,288.813,10,10,8,8,0,76,1.672,0,8,8,0,0,0
"DG_s06",80,289.813,290.516,291.656,291.656,28,4,10,10,24,76,1.14,1,28,4,24,0,-24
"DG_s06",81,292.656,293.36,295.391,295.391,22,6,10,10,16,82,2.031,1,22,6,16,0,-16
"DG_s06",82,296.391,297.094,299.656,299.656,30,15,10,10,15,76,2.562,1,30,15,15,0,-15
"DG_s06",83,300.656,301.36,303.016,303.016,28,4,10,10,24,76,1.656,1,28,4,24,0,-24
"DG_s06",84,304.016,304.719,308.375,308.375,10,10,4,4,0,76,3.656,0,4,4,0,0,0
"DG_s06",85,309.375,310.078,311.36,311.36,13,7,10,10,6,76,1.282,1,13,7,6,0,-6
"DG_s06",86,312.36,313.063,315.422,315.422,10,10,10,26,0,76,2.359,0,10,26,16,16,0
"DG_s06",87,316.422,317.125,317.891,317.906,10,10,13,22,0,76,0.766,0,13,22,9,9,0
"DG_s06",88,318.906,319.61,320.688,320.688,16,4,10,10,12,76,1.078,1,16,4,12,0,-12
"DG_s06",89,321.688,322.391,323.86,323.86,10,10,8,11,0,76,1.469,0,8,11,3,3,0
"DG_s06",90,324.86,325.563,327.078,327.078,18,18,10,10,0,76,1.515,1,18,18,0,0,0
"DG_s06",91,328.078,328.781,330.547,330.563,10,10,8,16,0,82,1.766,0,8,16,8,8,0
"DG_s06",92,331.563,332.266,334.516,334.516,10,10,3,17,0,76,2.25,0,3,17,14,14,0
"DG_s06",93,335.516,336.219,337.86,337.875,10,10,6,6,0,76,1.641,0,6,6,0,0,0
"DG_s06",94,338.875,339.578,340.5,340.516,10,10,14,26,0,76,0.922,0,14,26,12,12,0
"DG_s06",95,341.516,342.219,344.297,344.313,11,7,10,10,4,76,2.078,1,11,7,4,0,-4
"DG_s06",96,345.313,346.016,348.766,348.766,16,4,10,10,12,76,2.75,1,16,4,12,0,-12
"DG_s06",97,349.781,350.485,352.906,352.922,13,1,10,10,12,82,2.421,1,13,1,12,0,-12
"DG_s06",98,353.922,354.625,356.391,356.391,10,10,11,7,0,82,1.766,0,11,7,4,0,-4
"DG_s06",99,357.391,358.094,359.563,359.563,10,10,6,11,0,82,1.469,0,6,11,5,5,0
"DG_s06",100,360.563,361.266,362.891,362.891,10,10,15,30,0,82,1.625,0,15,30,15,15,0
"DG_s06",101,363.891,364.594,367.031,367.031,18,10,10,10,8,76,2.437,1,18,10,8,0,-8
"DG_s06",102,368.031,368.735,370.078,370.078,10,10,6,14,0,76,1.343,0,6,14,8,8,0
"DG_s06",103,371.094,371.797,373.313,373.313,10,10,10,22,0,76,1.516,0,10,22,12,12,0
"DG_s06",104,374.313,375.016,376.375,376.375,10,10,30,10,0,76,1.359,0,30,10,20,0,-20
"DG_s06",105,377.375,378.078,379.672,379.672,18,12,10,10,6,76,1.594,1,18,12,6,0,-6
"DG_s06",106,380.672,381.375,383.875,383.891,18,10,10,10,8,76,2.5,1,18,10,8,0,-8
"DG_s06",107,384.891,385.594,388.141,388.141,10,10,13,1,0,76,2.547,0,13,1,12,0,-12
"DG_s06",108,389.141,389.844,393.25,393.266,16,8,10,10,8,76,3.406,1,16,8,8,0,-8
"DG_s06",109,394.266,394.969,398.203,398.219,26,10,10,10,16,76,3.234,1,26,10,16,0,-16
"DG_s06",110,399.219,399.922,400.828,400.828,22,13,10,10,9,82,0.906,1,22,13,9,0,-9
"DG_s06",111,401.828,402.531,403.922,403.938,10,10,8,16,0,76,1.391,0,8,16,8,8,0
"DG_s06",112,404.938,405.641,408.625,408.625,10,10,12,18,0,82,2.984,0,12,18,6,6,0
"DG_s06",113,409.625,410.328,412.438,412.438,10,10,12,4,0,82,2.11,0,12,4,8,0,-8
"DG_s06",114,413.438,414.141,415.25,415.25,14,26,10,10,12,76,1.109,1,14,26,12,12,0
"DG_s06",115,416.25,416.953,418.875,418.891,10,10,10,30,0,76,1.922,0,10,30,20,20,0
"DG_s06",116,419.891,420.594,421.375,421.375,10,10,14,14,0,76,0.781,0,14,14,0,0,0
"DG_s06",117,422.375,423.078,424.375,424.375,10,10,6,14,0,76,1.297,0,6,14,8,8,0
"DG_s06",118,425.375,426.078,427.86,427.86,10,10,6,11,0,76,1.782,0,6,11,5,5,0
"DG_s06",119,428.875,429.578,430.672,430.672,30,15,10,10,15,76,1.094,1,30,15,15,0,-15
"DG_s06",120,431.672,432.375,433.86,433.86,10,10,3,17,0,76,1.485,0,3,17,14,14,0
"DG_s06",121,434.86,435.563,436.797,436.797,13,7,10,10,6,76,1.234,1,13,7,6,0,-6
"DG_s06",122,437.813,438.516,440.047,440.047,12,18,10,10,6,82,1.531,1,12,18,6,6,0
"DG_s06",123,441.047,441.75,442.438,442.438,16,8,10,10,8,76,0.688,1,16,8,8,0,-8
"DG_s06",124,443.438,444.141,446.453,446.453,10,10,10,30,0,76,2.312,0,10,30,20,20,0
"DG_s06",125,447.469,448.172,449.797,449.797,18,12,10,10,6,76,1.625,1,18,12,6,0,-6
"DG_s06",126,450.813,451.516,452.735,452.735,10,10,2,2,0,76,1.219,0,2,2,0,0,0
"DG_s06",127,453.735,454.438,455.391,455.391,10,10,3,31,0,76,0.953,0,3,31,28,28,0
"DG_s06",128,456.391,457.094,458.485,458.485,10,10,10,22,0,82,1.391,0,10,22,12,12,0
"DG_s06",129,459.485,460.188,461.36,461.375,26,10,10,10,16,82,1.172,1,26,10,16,0,-16
"DG_s06",130,462.375,463.078,464.875,464.875,30,10,10,10,20,76,1.797,1,30,10,20,0,-20
"DG_s06",131,465.875,466.578,468.5,468.5,10,10,6,22,0,82,1.922,0,6,22,16,16,0
"DG_s06",132,469.516,470.219,473.828,473.828,10,10,10,18,0,76,3.609,0,10,18,8,8,0
"DG_s06",133,474.828,475.531,477.36,477.36,10,10,13,22,0,82,1.829,0,13,22,9,9,0
"DG_s06",134,478.36,479.063,480.86,480.86,10,10,3,31,0,76,1.797,0,3,31,28,28,0
"DG_s06",135,481.86,482.563,485.797,485.797,26,14,10,10,12,82,3.234,1,26,14,12,0,-12
"DG_s06",136,486.797,487.5,489.11,489.11,18,2,10,10,16,82,1.61,1,18,2,16,0,-16
"DG_s06",137,490.11,490.813,492.938,492.953,16,16,10,10,0,76,2.125,1,16,16,0,0,0
"DG_s06",138,493.953,494.656,496.375,496.375,10,10,8,11,0,76,1.719,0,8,11,3,3,0
"DG_s06",139,497.375,498.078,500.547,500.547,10,10,10,26,0,76,2.469,0,10,26,16,16,0
"DG_s06",140,501.563,502.266,504.078,504.078,10,10,15,30,0,82,1.812,0,15,30,15,15,0
"DG_s06",141,505.078,505.781,506.813,506.813,22,10,10,10,12,76,1.032,1,22,10,12,0,-12
"DG_s06",142,507.828,508.531,510.797,510.797,12,4,10,10,8,76,2.266,1,12,4,8,0,-8
"DG_s06",143,511.797,512.5,514.375,514.391,26,14,10,10,12,82,1.875,1,26,14,12,0,-12
"DG_s06",144,515.391,516.094,517.891,517.891,22,6,10,10,16,76,1.797,1,22,6,16,0,-16
"DG_s06",145,518.891,519.594,521.11,521.11,10,10,6,22,0,82,1.516,0,6,22,16,16,0
"DG_s06",146,522.11,522.813,525.672,525.688,10,10,8,12,0,76,2.859,0,8,12,4,4,0
"DG_s06",147,526.688,527.391,529.813,529.813,10,10,3,12,0,82,2.422,0,3,12,9,9,0
"DG_s06",148,530.828,531.531,533.031,533.047,18,2,10,10,16,76,1.5,1,18,2,16,0,-16
"DG_s06",149,534.047,534.75,536.61,536.61,22,10,10,10,12,82,1.86,1,22,10,12,0,-12
"DG_s06",150,537.61,538.313,540.11,540.11,22,13,10,10,9,76,1.797,1,22,13,9,0,-9
"DG_s06",151,541.11,541.813,543.438,543.438,10,10,8,12,0,76,1.625,0,8,12,4,4,0
"DG_s06",152,544.438,545.141,546.047,546.047,10,10,3,12,0,76,0.906,0,3,12,9,9,0
"DG_s06",153,547.047,547.75,550.531,550.531,10,10,10,18,0,76,2.781,0,10,18,8,8,0
"DG_s06",154,551.547,552.25,553.75,553.75,12,12,10,10,0,76,1.5,1,12,12,0,0,0
"DG_s06",155,554.75,555.453,557.016,557.016,10,10,8,8,0,76,1.563,0,8,8,0,0,0
"DG_s06",156,558.016,558.719,559.969,559.969,28,4,10,10,24,76,1.25,1,28,4,24,0,-24
"DG_s06",157,560.969,561.672,564.516,564.516,22,6,10,10,16,82,2.844,1,22,6,16,0,-16
"DG_s06",158,565.516,566.219,567.625,567.625,30,15,10,10,15,76,1.406,1,30,15,15,0,-15
"DG_s06",159,568.625,569.328,570.094,570.094,28,4,10,10,24,76,0.766,1,28,4,24,0,-24
"DG_s06",160,571.094,571.797,573.031,573.031,10,10,4,4,0,76,1.234,0,4,4,0,0,0
"DG_s06",161,574.031,574.735,576.203,576.203,13,7,10,10,6,76,1.468,1,13,7,6,0,-6
"DG_s06",162,577.203,577.906,581.25,581.25,10,10,10,26,0,76,3.344,0,10,26,16,16,0
"DG_s06",163,582.266,582.969,584.86,584.86,10,10,13,22,0,76,1.891,0,13,22,9,9,0
"DG_s06",164,585.875,586.578,588.375,588.375,10,10,16,4,0,82,1.797,0,16,4,12,0,-12
"DG_s06",165,589.375,590.078,591.547,591.547,10,10,8,11,0,76,1.469,0,8,11,3,3,0
"DG_s06",166,592.547,593.25,594.594,594.61,18,18,10,10,0,76,1.344,1,18,18,0,0,0
"DG_s06",167,595.61,596.313,598.875,598.875,10,10,8,16,0,82,2.562,0,8,16,8,8,0
"DG_s06",168,599.891,600.594,602.453,602.453,10,10,3,17,0,76,1.859,0,3,17,14,14,0
"DG_s06",169,603.453,604.156,605.063,605.063,10,10,6,6,0,76,0.907,0,6,6,0,0,0
"DG_s06",170,606.063,606.766,608.516,608.516,10,10,14,26,0,76,1.75,0,14,26,12,12,0
"DG_s06",171,609.516,610.219,613.203,613.203,10,10,11,7,0,82,2.984,0,11,7,4,0,-4
"DG_s06",172,614.219,614.922,616.266,616.266,16,4,10,10,12,76,1.344,1,16,4,12,0,-12
"DG_s06",173,617.266,617.969,619.625,619.625,13,1,10,10,12,82,1.656,1,13,1,12,0,-12
"DG_s06",174,620.625,621.328,623.547,623.547,11,7,10,10,4,76,2.219,1,11,7,4,0,-4
"DG_s06",175,624.547,625.25,628.344,628.344,10,10,6,11,0,82,3.094,0,6,11,5,5,0
"DG_s06",176,629.344,630.047,631.922,631.922,10,10,15,30,0,82,1.875,0,15,30,15,15,0
"DG_s06",177,632.938,633.641,635.594,635.594,18,10,10,10,8,76,1.953,1,18,10,8,0,-8
"DG_s06",178,636.61,637.313,639.266,639.266,10,10,6,14,0,76,1.953,0,6,14,8,8,0
"DG_s06",179,640.281,640.985,641.75,641.766,10,10,10,22,0,76,0.765,0,10,22,12,12,0
"DG_s06",180,642.766,643.469,644.438,644.438,30,10,10,10,20,82,0.969,1,30,10,20,0,-20
"DG_s06",181,645.438,646.141,647.531,647.531,18,12,10,10,6,76,1.39,1,18,12,6,0,-6
"DG_s06",182,648.531,649.235,649.969,649.969,18,10,10,10,8,76,0.734,1,18,10,8,0,-8
"DG_s06",183,650.969,651.672,653.219,653.219,13,1,10,10,12,82,1.547,1,13,1,12,0,-12
"DG_s06",184,654.235,654.938,656.969,656.969,16,8,10,10,8,76,2.031,1,16,8,8,0,-8
"DG_s06",185,657.969,658.672,659.375,659.375,26,10,10,10,16,76,0.703,1,26,10,16,0,-16
"DG_s06",186,660.375,661.078,661.969,661.969,22,13,10,10,9,82,0.891,1,22,13,9,0,-9
"DG_s06",187,662.969,663.672,664.75,664.766,10,10,8,16,0,76,1.078,0,8,16,8,8,0
"DG_s06",188,665.766,666.469,667.625,667.625,10,10,12,18,0,82,1.156,0,12,18,6,6,0
"DG_s06",189,668.641,669.344,670.453,670.469,12,4,10,10,8,76,1.109,1,12,4,8,0,-8
"DG_s06",190,671.469,672.172,675.485,675.485,14,26,10,10,12,76,3.313,1,14,26,12,12,0
"DG_s06",191,676.485,677.188,678.766,678.766,10,10,10,30,0,76,1.578,0,10,30,20,20,0
"DG_s06",192,679.766,680.469,682.766,682.766,14,14,10,10,0,82,2.297,1,14,14,0,0,0
"DG_s06",193,683.766,684.469,686.578,686.578,10,10,6,14,0,76,2.109,0,6,14,8,8,0
"DG_s06",194,687.594,688.297,689.156,689.156,10,10,6,11,0,76,0.859,0,6,11,5,5,0
"DG_s06",195,690.156,690.86,692.469,692.469,30,15,10,10,15,76,1.609,1,30,15,15,0,-15
"DG_s06",196,693.469,694.172,695.781,695.797,10,10,3,17,0,76,1.609,0,3,17,14,14,0
"DG_s06",197,696.797,697.5,700.297,700.297,13,7,10,10,6,76,2.797,1,13,7,6,0,-6
"DG_s06",198,701.297,702,703.828,703.828,10,10,12,18,0,76,1.828,0,12,18,6,6,0
"DG_s06",199,704.828,705.531,707.766,707.766,16,8,10,10,8,76,2.235,1,16,8,8,0,-8
"DG_s06",200,708.766,709.469,711.578,711.578,10,10,10,30,0,76,2.109,0,10,30,20,20,0
"DG_s06",201,712.594,713.297,716.188,716.188,18,12,10,10,6,76,2.891,1,18,12,6,0,-6
"DG_s06",202,717.188,717.891,720.25,720.25,10,10,2,2,0,76,2.359,0,2,2,0,0,0
"DG_s06",203,721.25,721.953,723.031,723.031,10,10,3,31,0,76,1.078,0,3,31,28,28,0
"DG_s06",204,724.031,724.735,726.516,726.516,10,10,10,22,0,82,1.781,0,10,22,12,12,0
"DG_s06",205,727.516,728.219,729.36,729.375,26,10,10,10,16,82,1.141,1,26,10,16,0,-16
"DG_s06",206,730.375,731.078,732.672,732.688,30,10,10,10,20,76,1.594,1,30,10,20,0,-20
"DG_s06",207,733.688,734.391,737.203,737.203,10,10,6,22,0,82,2.812,0,6,22,16,16,0
"DG_s06",208,738.203,738.906,740.672,740.672,10,10,10,18,0,76,1.766,0,10,18,8,8,0
"DG_s06",209,741.672,742.375,743.625,743.625,10,10,13,22,0,82,1.25,0,13,22,9,9,0
"DG_s06",210,744.625,745.328,747.281,747.281,3,31,10,10,28,82,1.953,1,3,31,28,28,0
"DG_s06",211,748.297,749,749.891,749.891,26,14,10,10,12,82,0.891,1,26,14,12,0,-12
"DG_s06",212,750.891,751.594,752.735,752.75,18,2,10,10,16,82,1.141,1,18,2,16,0,-16
"DG_s06",213,753.75,754.453,756.016,756.031,16,16,10,10,0,76,1.563,1,16,16,0,0,0
"DG_s06",214,757.031,757.735,758.985,758.985,10,10,8,11,0,76,1.25,0,8,11,3,3,0
"DG_s06",215,759.985,760.688,761.344,761.36,10,10,10,26,0,76,0.656,0,10,26,16,16,0
"DG_s06",216,762.36,763.063,764.797,764.797,10,10,15,30,0,82,1.734,0,15,30,15,15,0
"DG_s06",217,765.797,766.5,767.563,767.563,22,10,10,10,12,76,1.063,1,22,10,12,0,-12
"DG_s06",218,768.563,769.266,770.953,770.953,12,4,10,10,8,76,1.687,1,12,4,8,0,-8
"DG_s06",219,771.969,772.672,773.813,773.828,26,14,10,10,12,82,1.141,1,26,14,12,0,-12
"DG_s06",220,774.828,775.531,776.641,776.641,22,6,10,10,16,76,1.11,1,22,6,16,0,-16
"DG_s06",221,777.641,778.344,779.25,779.25,10,10,6,22,0,82,0.906,0,6,22,16,16,0
"DG_s06",222,780.25,780.953,784.235,784.235,10,10,8,12,0,76,3.282,0,8,12,4,4,0
"DG_s06",223,785.235,785.938,788.985,788.985,10,10,3,12,0,82,3.047,0,3,12,9,9,0
"DG_s06",224,789.985,790.688,792.813,792.828,18,2,10,10,16,76,2.125,1,18,2,16,0,-16
"DG_s06",225,793.828,794.531,796.141,796.141,22,10,10,10,12,82,1.61,1,22,10,12,0,-12
"DG_s06",226,797.141,797.844,798.625,798.625,22,13,10,10,9,76,0.781,1,22,13,9,0,-9
"DG_s06",227,799.641,800.344,801.985,801.985,10,10,8,12,0,76,1.641,0,8,12,4,4,0
"DG_s06",228,803,803.703,804.438,804.438,10,10,3,12,0,76,0.735,0,3,12,9,9,0
"DG_s07",1,-0.765,0,2.141,2.141,10,18,10,10,8,82,2.141,1,10,18,8,8,0
"DG_s07",2,3.141,3.907,6.735,6.735,12,12,10,10,0,76,2.828,1,12,12,0,0,0
"DG_s07",3,7.735,8.5,11.329,11.344,8,8,10,10,0,82,2.829,1,8,8,0,0,0
"DG_s07",4,12.344,13.11,15.282,15.282,28,4,10,10,24,76,2.172,1,28,4,24,0,-24
"DG_s07",5,16.282,17.047,18.954,18.954,22,6,10,10,16,82,1.907,1,22,6,16,0,-16
"DG_s07",6,19.954,20.719,22.641,22.641,30,15,10,10,15,76,1.922,1,30,15,15,0,-15
"DG_s07",7,23.641,24.407,25.688,25.688,28,4,10,10,24,76,1.281,1,28,4,24,0,-24
"DG_s07",8,26.688,27.454,29.719,29.719,10,10,4,4,0,76,2.265,0,4,4,0,0,0
"DG_s07",9,30.719,31.485,33.516,33.516,10,10,13,7,0,82,2.031,0,13,7,6,0,-6
"DG_s07",10,34.532,35.297,36.688,36.704,10,26,10,10,16,82,1.391,1,10,26,16,16,0
"DG_s07",11,37.704,38.469,39.469,39.469,13,22,10,10,9,82,1,1,13,22,9,9,0
"DG_s07",12,40.469,41.235,43.829,43.829,10,10,16,4,0,82,2.594,0,16,4,12,0,-12
"DG_s07",13,44.829,45.594,48.235,48.235,10,10,8,11,0,76,2.641,0,8,11,3,3,0
"DG_s07",14,49.235,50,52.047,52.047,18,18,10,10,0,76,2.047,1,18,18,0,0,0
"DG_s07",15,53.047,53.813,56.016,56.032,10,10,8,16,0,82,2.203,0,8,16,8,8,0
"DG_s07",16,57.032,57.797,60.391,60.391,10,10,3,17,0,76,2.594,0,3,17,14,14,0
"DG_s07",17,61.391,62.157,63.532,63.532,10,10,6,6,0,76,1.375,0,6,6,0,0,0
"DG_s07",18,64.532,65.297,66.329,66.344,10,10,14,26,0,76,1.032,0,14,26,12,12,0
"DG_s07",19,67.344,68.11,70.969,70.969,10,10,11,7,0,82,2.859,0,11,7,4,0,-4
"DG_s07",20,71.969,72.735,76.563,76.563,16,4,10,10,12,76,3.828,1,16,4,12,0,-12
"DG_s07",21,77.579,78.344,80.844,80.844,10,10,13,1,0,76,2.5,0,13,1,12,0,-12
"DG_s07",23,87.625,88.391,90.235,90.235,10,10,6,11,0,82,1.844,0,6,11,5,5,0
"DG_s07",24,91.25,92.016,93.141,93.141,15,30,10,10,15,76,1.125,1,15,30,15,15,0
"DG_s07",25,94.141,94.907,96.344,96.36,18,10,10,10,8,76,1.437,1,18,10,8,0,-8
"DG_s07",26,97.36,98.125,101.797,101.797,10,10,6,14,0,76,3.672,0,6,14,8,8,0
"DG_s07",27,102.797,103.563,105.157,105.157,10,22,10,10,12,82,1.594,1,10,22,12,12,0
"DG_s07",28,106.157,106.922,108.5,108.5,30,10,10,10,20,82,1.578,1,30,10,20,0,-20
"DG_s07",29,109.516,110.282,112.25,112.25,18,12,10,10,6,76,1.968,1,18,12,6,0,-6
"DG_s07",30,113.25,114.016,117.938,117.954,18,10,10,10,8,76,3.922,1,18,10,8,0,-8
"DG_s07",34,136.25,137.016,139.188,139.188,22,13,10,10,9,82,2.172,1,22,13,9,0,-9
"DG_s07",35,140.188,140.954,143.938,143.938,10,10,8,16,0,76,2.984,0,8,16,8,8,0
"DG_s07",36,144.938,145.704,147.625,147.625,12,18,10,10,6,76,1.921,1,12,18,6,6,0
"DG_s07",37,148.625,149.391,151.219,151.219,10,10,12,4,0,82,1.828,0,12,4,8,0,-8
"DG_s07",38,152.219,152.985,153.735,153.735,14,26,10,10,12,76,0.75,1,14,26,12,12,0
"DG_s07",39,154.735,155.5,157.25,157.25,10,30,10,10,20,82,1.75,1,10,30,20,20,0
"DG_s07",40,158.266,159.032,160.063,160.079,10,10,14,14,0,76,1.031,0,14,14,0,0,0
"DG_s07",41,161.079,161.844,163.875,163.875,10,10,6,14,0,76,2.031,0,6,14,8,8,0
"DG_s07",42,164.875,165.641,169,169,6,11,10,10,5,82,3.359,1,6,11,5,5,0
"DG_s07",43,170,170.766,172.891,172.891,30,15,10,10,15,76,2.125,1,30,15,15,0,-15
"DG_s07",44,173.891,174.657,176.625,176.641,3,17,10,10,14,82,1.968,1,3,17,14,14,0
"DG_s07",45,177.641,178.407,179.969,179.985,10,10,13,7,0,82,1.562,0,13,7,6,0,-6
"DG_s07",46,180.985,181.75,183.266,183.266,12,18,10,10,6,82,1.516,1,12,18,6,6,0
"DG_s07",47,184.266,185.032,186.36,186.36,10,10,16,8,0,82,1.328,0,16,8,8,0,-8
"DG_s07",48,187.36,188.125,189.266,189.282,10,30,10,10,20,82,1.141,1,10,30,20,20,0
"DG_s07",49,190.282,191.047,193.516,193.516,18,12,10,10,6,76,2.469,1,18,12,6,0,-6
"DG_s07",50,194.516,195.282,196.563,196.563,10,10,2,2,0,76,1.281,0,2,2,0,0,0
"DG_s07",51,197.579,198.344,199.797,199.797,3,31,10,10,28,82,1.453,1,3,31,28,28,0
"DG_s07",52,200.797,201.563,202.407,202.422,10,22,10,10,12,76,0.844,1,10,22,12,12,0
"DG_s07",53,203.422,204.188,207.985,207.985,10,10,26,10,0,76,3.797,0,26,10,16,0,-16
"DG_s07",54,208.985,209.75,211.407,211.422,10,10,30,10,0,82,1.657,0,30,10,20,0,-20
"DG_s07",55,212.422,213.188,215.469,215.469,10,10,6,22,0,82,2.281,0,6,22,16,16,0
"DG_s07",56,216.469,217.235,219.188,219.188,10,18,10,10,8,82,1.953,1,10,18,8,8,0
"DG_s07",57,220.188,220.954,222.735,222.75,13,22,10,10,9,76,1.781,1,13,22,9,9,0
"DG_s07",58,223.75,224.516,226.313,226.329,3,31,10,10,28,82,1.797,1,3,31,28,28,0
"DG_s07",59,227.329,228.094,230.25,230.25,10,10,26,14,0,76,2.156,0,26,14,12,0,-12
"DG_s07",60,231.266,232.032,234.36,234.375,10,10,18,2,0,76,2.328,0,18,2,16,0,-16
"DG_s07",61,235.375,236.141,240,240,10,10,16,16,0,82,3.859,0,16,16,0,0,0
"DG_s07",62,241,241.766,244.516,244.516,10,10,8,11,0,76,2.75,0,8,11,3,3,0
"DG_s07",63,245.532,246.297,248,248,10,26,10,10,16,82,1.703,1,10,26,16,16,0
"DG_s07",64,249,249.766,251.313,251.329,15,30,10,10,15,76,1.547,1,15,30,15,15,0
"DG_s07",65,252.329,253.094,254.266,254.266,10,10,22,10,0,82,1.172,0,22,10,12,0,-12
"DG_s07",66,255.282,256.047,257.922,257.922,10,10,12,4,0,82,1.875,0,12,4,8,0,-8
"DG_s07",67,258.922,259.688,261.86,261.86,10,10,26,14,0,76,2.172,0,26,14,12,0,-12
"DG_s07",68,262.86,263.625,265.313,265.313,10,10,22,6,0,82,1.688,0,22,6,16,0,-16
"DG_s07",69,266.313,267.079,269.047,269.047,6,22,10,10,16,76,1.968,1,6,22,16,16,0
"DG_s07",70,270.047,270.813,273.204,273.204,8,12,10,10,4,82,2.391,1,8,12,4,4,0
"DG_s07",71,274.219,274.985,277.672,277.688,3,12,10,10,9,76,2.687,1,3,12,9,9,0
"DG_s07",72,278.688,279.454,281.907,281.907,10,10,18,2,0,82,2.453,0,18,2,16,0,-16
"DG_s07",73,282.907,283.672,285.735,285.735,10,10,22,10,0,76,2.063,0,22,10,12,0,-12
"DG_s07",74,286.735,287.5,289.704,289.704,10,10,22,13,0,82,2.204,0,22,13,9,0,-9
"DG_s07",75,290.704,291.469,293.282,293.282,8,12,10,10,4,82,1.813,1,8,12,4,4,0
"DG_s07",76,294.297,295.063,297.688,297.688,3,12,10,10,9,82,2.625,1,3,12,9,9,0
"DG_s07",77,298.688,299.454,300.813,300.813,10,18,10,10,8,82,1.359,1,10,18,8,8,0
"DG_s07",78,301.813,302.579,304.188,304.188,10,10,12,12,0,82,1.609,0,12,12,0,0,0
"DG_s07",79,305.188,305.954,308.891,308.891,10,10,8,8,0,76,2.937,0,8,8,0,0,0
"DG_s07",80,309.891,310.657,312.704,312.704,10,10,28,4,0,82,2.047,0,28,4,24,0,-24
"DG_s07",81,313.704,314.469,316.454,316.454,10,10,22,6,0,76,1.985,0,22,6,16,0,-16
"DG_s07",82,317.454,318.219,320.063,320.063,10,10,30,15,0,82,1.844,0,30,15,15,0,-15
"DG_s07",83,321.063,321.829,323.422,323.438,10,10,28,4,0,82,1.593,0,28,4,24,0,-24
"DG_s07",84,324.438,325.204,327.547,327.547,10,10,4,4,0,76,2.343,0,4,4,0,0,0
"DG_s07",85,328.547,329.313,331.5,331.5,10,10,13,7,0,82,2.187,0,13,7,6,0,-6
"DG_s07",86,332.5,333.266,334.407,334.407,10,26,10,10,16,82,1.141,1,10,26,16,16,0
"DG_s07",87,335.407,336.172,337,337.016,13,22,10,10,9,82,0.828,1,13,22,9,9,0
"DG_s07",88,338.016,338.782,339.891,339.891,10,10,16,4,0,82,1.109,0,16,4,12,0,-12
"DG_s07",89,340.891,341.657,343.032,343.032,8,11,10,10,3,82,1.375,1,8,11,3,3,0
"DG_s07",90,344.032,344.797,346.422,346.438,18,18,10,10,0,76,1.625,1,18,18,0,0,0
"DG_s07",91,347.438,348.204,350.797,350.813,10,10,8,16,0,82,2.593,0,8,16,8,8,0
"DG_s07",92,351.813,352.579,355.063,355.063,3,17,10,10,14,82,2.484,1,3,17,14,14,0
"DG_s07",93,356.063,356.829,358.844,358.844,10,10,6,6,0,76,2.015,0,6,6,0,0,0
"DG_s07",94,359.844,360.61,362.235,362.235,14,26,10,10,12,82,1.625,1,14,26,12,12,0
"DG_s07",95,363.25,364.016,366.547,366.547,10,10,11,7,0,82,2.531,0,11,7,4,0,-4
"DG_s07",96,367.547,368.313,369.469,369.469,10,10,16,4,0,82,1.156,0,16,4,12,0,-12
"DG_s07",97,370.469,371.235,373.75,373.766,10,10,13,1,0,76,2.515,0,13,1,12,0,-12
"DG_s07",98,374.766,375.532,376.719,376.735,10,10,11,7,0,82,1.187,0,11,7,4,0,-4
"DG_s07",99,377.735,378.5,382.047,382.063,10,10,6,11,0,82,3.547,0,6,11,5,5,0
"DG_s07",100,383.063,383.829,387.36,387.36,15,30,10,10,15,76,3.531,1,15,30,15,15,0
"DG_s07",102,394.125,394.891,652.875,652.891,10,10,6,14,0,76,257.984,0,6,14,8,8,0
"DG_s07",103,653.891,654.657,655.735,655.735,10,22,10,10,12,82,1.078,1,10,22,12,12,0
"DG_s07",104,656.735,657.5,659.219,659.235,10,10,30,10,0,76,1.719,0,30,10,20,0,-20
"DG_s07",105,660.235,661,663.344,663.344,10,10,18,12,0,82,2.344,0,18,12,6,0,-6
"DG_s07",106,664.344,665.11,667.047,667.047,10,10,18,10,0,82,1.937,0,18,10,8,0,-8
"DG_s07",107,668.047,668.813,671.282,671.282,10,10,13,1,0,76,2.469,0,13,1,12,0,-12
"DG_s07",108,672.282,673.047,676.079,676.079,10,10,16,8,0,82,3.032,0,16,8,8,0,-8
"DG_s07",109,677.079,677.844,679.032,679.032,10,10,26,10,0,82,1.188,0,26,10,16,0,-16
"DG_s07",110,680.047,680.813,682.188,682.188,10,10,22,13,0,76,1.375,0,22,13,9,0,-9
"DG_s07",111,683.188,683.954,685.719,685.719,8,16,10,10,8,82,1.765,1,8,16,8,8,0
"DG_s07",112,686.735,687.5,689.657,689.657,12,18,10,10,6,76,2.157,1,12,18,6,6,0
"DG_s07",113,690.657,691.422,692.313,692.313,10,10,12,4,0,82,0.891,0,12,4,8,0,-8
"DG_s07",114,693.313,694.079,695.094,695.094,14,26,10,10,12,76,1.015,1,14,26,12,12,0
"DG_s07",115,696.094,696.86,697.782,697.797,10,30,10,10,20,82,0.922,1,10,30,20,20,0
"DG_s07",116,698.797,699.563,702.641,702.641,14,14,10,10,0,82,3.078,1,14,14,0,0,0
"DG_s07",117,703.641,704.407,705.954,705.954,6,14,10,10,8,82,1.547,1,6,14,8,8,0
"DG_s07",118,706.954,707.719,709.36,709.36,6,11,10,10,5,82,1.641,1,6,11,5,5,0
"DG_s07",119,710.375,711.141,713.563,713.579,10,10,30,15,0,82,2.422,0,30,15,15,0,-15
"DG_s07",120,714.579,715.344,717.063,717.063,3,17,10,10,14,82,1.719,1,3,17,14,14,0
"DG_s07",121,718.079,718.844,722.047,722.047,10,10,13,7,0,82,3.203,0,13,7,6,0,-6
"DG_s07",122,723.063,723.829,725.625,725.625,12,18,10,10,6,82,1.796,1,12,18,6,6,0
"DG_s07",123,726.625,727.391,729.079,729.079,10,10,16,8,0,82,1.688,0,16,8,8,0,-8
"DG_s07",124,730.079,730.844,731.954,731.954,10,30,10,10,20,82,1.11,1,10,30,20,20,0
"DG_s07",125,732.954,733.719,735.797,735.813,10,10,18,12,0,82,2.078,0,18,12,6,0,-6
"DG_s07",126,736.813,737.579,740.11,740.11,10,10,2,2,0,76,2.531,0,2,2,0,0,0
"DG_s07",127,741.125,741.891,742.875,742.891,3,31,10,10,28,82,0.984,1,3,31,28,28,0
"DG_s07",128,743.891,744.657,745.829,745.829,10,22,10,10,12,76,1.172,1,10,22,12,12,0
"DG_s07",129,746.829,747.594,749.75,749.75,10,10,26,10,0,76,2.156,0,26,10,16,0,-16
"DG_s07",130,750.75,751.516,752.594,752.61,10,10,30,10,0,82,1.078,0,30,10,20,0,-20
"DG_s07",131,753.61,754.375,755.313,755.313,6,22,10,10,16,76,0.938,1,6,22,16,16,0
"DG_s07",132,756.313,757.079,758.11,758.11,10,18,10,10,8,82,1.031,1,10,18,8,8,0
"DG_s07",133,759.125,759.891,761.032,761.032,13,22,10,10,9,76,1.141,1,13,22,9,9,0
"DG_s07",134,762.047,762.813,763.797,763.797,3,31,10,10,28,82,0.984,1,3,31,28,28,0
"DG_s07",135,764.797,765.563,767.344,767.344,10,10,26,14,0,76,1.781,0,26,14,12,0,-12
"DG_s07",136,768.344,769.11,771.297,771.297,10,10,18,2,0,76,2.187,0,18,2,16,0,-16
"DG_s07",137,772.297,773.063,775.641,775.641,16,16,10,10,0,76,2.578,1,16,16,0,0,0
"DG_s07",138,776.641,777.407,779.672,779.672,10,10,8,11,0,76,2.265,0,8,11,3,3,0
"DG_s07",139,780.672,781.438,782.641,782.641,10,26,10,10,16,82,1.203,1,10,26,16,16,0
"DG_s07",140,783.641,784.407,786.079,786.079,15,30,10,10,15,76,1.672,1,15,30,15,15,0
"DG_s07",141,787.094,787.86,789.797,789.813,10,10,22,10,0,82,1.937,0,22,10,12,0,-12
"DG_s07",142,790.813,791.579,793.407,793.407,10,10,12,4,0,82,1.828,0,12,4,8,0,-8
"DG_s07",143,794.407,795.172,797.235,797.235,10,10,26,14,0,76,2.063,0,26,14,12,0,-12
"DG_s07",144,798.235,799,800.391,800.391,10,10,22,6,0,82,1.391,0,22,6,16,0,-16
"DG_s07",145,801.407,802.172,803.297,803.297,6,22,10,10,16,76,1.125,1,6,22,16,16,0
"DG_s07",146,804.297,805.063,807.094,807.094,8,12,10,10,4,82,2.031,1,8,12,4,4,0
"DG_s07",147,808.11,808.875,810.782,810.782,3,12,10,10,9,76,1.907,1,3,12,9,9,0
"DG_s07",148,811.782,812.547,814.344,814.344,10,10,18,2,0,82,1.797,0,18,2,16,0,-16
"DG_s07",149,815.344,816.11,817.813,817.829,10,10,22,10,0,76,1.703,0,22,10,12,0,-12
"DG_s07",150,818.829,819.594,821.672,821.672,10,10,22,13,0,82,2.078,0,22,13,9,0,-9
"DG_s07",151,822.672,823.438,825.36,825.36,8,12,10,10,4,82,1.922,1,8,12,4,4,0
"DG_s07",152,826.36,827.125,829,829,3,12,10,10,9,82,1.875,1,3,12,9,9,0
"DG_s07",153,830,830.766,832.391,832.391,10,18,10,10,8,82,1.625,1,10,18,8,8,0
"DG_s07",154,833.391,834.157,836.829,836.829,12,12,10,10,0,76,2.672,1,12,12,0,0,0
"DG_s07",155,837.829,838.594,840.61,840.625,8,8,10,10,0,82,2.016,1,8,8,0,0,0
"DG_s07",156,841.625,842.391,844.485,844.5,10,10,28,4,0,82,2.094,0,28,4,24,0,-24
"DG_s07",157,845.5,846.266,848.907,848.907,10,10,22,6,0,76,2.641,0,22,6,16,0,-16
"DG_s07",158,849.907,850.672,852.204,852.204,10,10,30,15,0,82,1.532,0,30,15,15,0,-15
"DG_s07",159,853.204,853.969,855.782,855.782,10,10,28,4,0,82,1.813,0,28,4,24,0,-24
"DG_s07",160,856.797,857.563,859.641,859.657,10,10,4,4,0,76,2.078,0,4,4,0,0,0
"DG_s07",161,860.657,861.422,862.844,862.86,10,10,13,7,0,82,1.422,0,13,7,6,0,-6
"DG_s07",162,863.86,864.625,865.844,865.844,10,26,10,10,16,82,1.219,1,10,26,16,16,0
"DG_s07",163,866.844,867.61,869.782,869.782,13,22,10,10,9,82,2.172,1,13,22,9,9,0
"DG_s07",164,870.797,871.563,874.672,874.672,10,10,16,4,0,82,3.109,0,16,4,12,0,-12
"DG_s07",165,875.672,876.438,877.672,877.672,8,11,10,10,3,82,1.234,1,8,11,3,3,0
"DG_s07",167,884.438,885.204,887.782,887.782,8,16,10,10,8,76,2.578,1,8,16,8,8,0
"DG_s07",168,888.797,889.563,892,892,3,17,10,10,14,82,2.437,1,3,17,14,14,0
"DG_s07",169,893,893.766,895.579,895.594,10,10,6,6,0,76,1.813,0,6,6,0,0,0
"DG_s07",170,896.594,897.36,899,899,14,26,10,10,12,82,1.64,1,14,26,12,12,0
"DG_s07",171,900,900.766,902.61,902.61,10,10,11,7,0,82,1.844,0,11,7,4,0,-4
"DG_s07",172,903.61,904.375,907.047,907.047,10,10,16,4,0,82,2.672,0,16,4,12,0,-12
"DG_s07",173,908.047,908.813,911.282,911.282,10,10,13,1,0,76,2.469,0,13,1,12,0,-12
"DG_s07",174,912.282,913.047,915.219,915.219,10,10,11,7,0,82,2.172,0,11,7,4,0,-4
"DG_s07",175,916.219,916.985,918.579,918.579,6,11,10,10,5,76,1.594,1,6,11,5,5,0
"DG_s07",176,919.579,920.344,922.016,922.016,15,30,10,10,15,76,1.672,1,15,30,15,15,0
"DG_s07",177,923.016,923.782,925.547,925.563,10,10,18,10,0,82,1.765,0,18,10,8,0,-8
"DG_s07",178,926.563,927.329,929.313,929.329,6,14,10,10,8,82,1.984,1,6,14,8,8,0
"DG_s07",179,930.329,931.094,932.907,932.907,10,22,10,10,12,82,1.813,1,10,22,12,12,0
"DG_s07",180,933.907,934.672,937.157,937.157,10,10,30,10,0,76,2.485,0,30,10,20,0,-20
"DG_s07",181,938.157,938.922,940.922,940.938,10,10,18,12,0,82,2,0,18,12,6,0,-6
"DG_s07",182,941.938,942.704,943.954,943.954,10,10,18,10,0,82,1.25,0,18,10,8,0,-8
"DG_s07",183,944.954,945.719,947.344,947.344,10,10,13,1,0,76,1.625,0,13,1,12,0,-12
"DG_s07",184,948.344,949.11,950.969,950.969,10,10,16,8,0,82,1.859,0,16,8,8,0,-8
"DG_s07",185,951.969,952.735,953.766,953.766,10,10,26,10,0,82,1.031,0,26,10,16,0,-16
"DG_s07",186,954.782,955.547,957.11,957.11,10,10,22,13,0,76,1.563,0,22,13,9,0,-9
"DG_s07",187,958.11,958.875,961.844,961.844,8,16,10,10,8,82,2.969,1,8,16,8,8,0
"DG_s07",188,962.86,963.625,965.422,965.422,12,18,10,10,6,76,1.797,1,12,18,6,6,0
"DG_s07",189,966.422,967.188,969.344,969.344,10,10,12,4,0,82,2.156,0,12,4,8,0,-8
"DG_s07",191,976.11,976.875,978.079,978.079,10,30,10,10,20,82,1.204,1,10,30,20,20,0
"DG_s07",192,979.079,979.844,981.875,981.875,14,14,10,10,0,82,2.031,1,14,14,0,0,0
"DG_s07",193,982.875,983.641,985.75,985.75,6,14,10,10,8,82,2.109,1,6,14,8,8,0
"DG_s07",194,986.75,987.516,988.704,988.704,6,11,10,10,5,82,1.188,1,6,11,5,5,0
"DG_s07",195,989.704,990.469,993.329,993.344,10,10,30,15,0,82,2.86,0,30,15,15,0,-15
"DG_s07",196,994.344,995.11,996.141,996.141,3,17,10,10,14,82,1.031,1,3,17,14,14,0
"DG_s07",197,997.141,997.907,999.735,999.735,10,10,13,7,0,82,1.828,0,13,7,6,0,-6
"DG_s07",198,1000.735,1001.5,1002.829,1002.829,12,18,10,10,6,82,1.329,1,12,18,6,6,0
"DG_s07",199,1003.844,1004.61,1007.375,1007.375,10,10,16,8,0,82,2.765,0,16,8,8,0,-8
"DG_s07",200,1008.375,1009.141,1010.219,1010.235,10,30,10,10,20,82,1.078,1,10,30,20,20,0
"DG_s07",201,1011.235,1012,1014.5,1014.5,10,10,18,12,0,82,2.5,0,18,12,6,0,-6
"DG_s07",202,1015.5,1016.266,1017.469,1017.469,10,10,2,2,0,76,1.203,0,2,2,0,0,0
"DG_s07",203,1018.469,1019.235,1020.235,1020.25,3,31,10,10,28,82,1,1,3,31,28,28,0
"DG_s07",204,1021.25,1022.016,1022.829,1022.829,10,22,10,10,12,76,0.813,1,10,22,12,12,0
"DG_s07",205,1023.844,1024.61,1026.407,1026.407,10,10,26,10,0,76,1.797,0,26,10,16,0,-16
"DG_s07",206,1027.407,1028.172,1029.5,1029.5,10,10,30,10,0,82,1.328,0,30,10,20,0,-20
"DG_s07",207,1030.5,1031.266,1032.063,1032.063,6,22,10,10,16,76,0.797,1,6,22,16,16,0
"DG_s07",208,1033.063,1033.829,1034.969,1034.969,10,18,10,10,8,82,1.14,1,10,18,8,8,0
"DG_s07",209,1035.969,1036.735,1037.844,1037.844,13,22,10,10,9,76,1.109,1,13,22,9,9,0
"DG_s07",210,1038.86,1039.625,1040.704,1040.704,3,31,10,10,28,82,1.079,1,3,31,28,28,0
"DG_s07",211,1041.704,1042.469,1044.282,1044.297,10,10,26,14,0,76,1.813,0,26,14,12,0,-12
"DG_s07",212,1045.297,1046.063,1047.235,1047.25,10,10,18,2,0,76,1.172,0,18,2,16,0,-16
"DG_s07",213,1048.25,1049.016,1050.719,1050.719,16,16,10,10,0,76,1.703,1,16,16,0,0,0
"DG_s07",214,1051.719,1052.485,1055,1055.016,8,11,10,10,3,82,2.515,1,8,11,3,3,0
"DG_s07",215,1056.016,1056.782,1058.25,1058.25,10,26,10,10,16,82,1.468,1,10,26,16,16,0
"DG_s07",216,1059.25,1060.016,1061.157,1061.157,15,30,10,10,15,76,1.141,1,15,30,15,15,0
"DG_s07",217,1062.157,1062.922,1064.891,1064.891,10,10,22,10,0,82,1.969,0,22,10,12,0,-12
"DG_s07",218,1065.891,1066.657,1068.344,1068.344,10,10,12,4,0,82,1.687,0,12,4,8,0,-8
"DG_s07",219,1069.344,1070.11,1072.079,1072.079,10,10,26,14,0,76,1.969,0,26,14,12,0,-12
"DG_s07",220,1073.079,1073.844,1074.891,1074.891,10,10,22,6,0,82,1.047,0,22,6,16,0,-16
"DG_s07",221,1075.891,1076.657,1077.797,1077.797,6,22,10,10,16,76,1.14,1,6,22,16,16,0
"DG_s07",222,1078.813,1079.579,1080.969,1080.985,8,12,10,10,4,82,1.39,1,8,12,4,4,0
"DG_s07",223,1081.985,1082.75,1084.079,1084.079,3,12,10,10,9,76,1.329,1,3,12,9,9,0
"DG_s07",224,1085.079,1085.844,1087.86,1087.86,10,10,18,2,0,82,2.016,0,18,2,16,0,-16
"DG_s07",225,1088.875,1089.641,1092.844,1092.844,10,10,22,10,0,76,3.203,0,22,10,12,0,-12
"DG_s07",226,1093.844,1094.61,1096.344,1096.344,10,10,22,13,0,82,1.734,0,22,13,9,0,-9
"DG_s07",227,1097.344,1098.11,1099.954,1099.969,8,12,10,10,4,82,1.844,1,8,12,4,4,0
"DG_s07",228,1100.969,1101.735,1103.016,1103.032,3,12,10,10,9,82,1.281,1,3,12,9,9,0
"DG_s08",1,-0.671,0,1.25,1.266,10,10,10,18,0,76,1.25,0,10,18,8,8,0
"DG_s08",2,2.266,2.938,4.079,4.079,10,10,12,12,0,82,1.141,0,12,12,0,0,0
"DG_s08",3,5.094,5.766,7.047,7.047,10,10,8,8,0,76,1.281,0,8,8,0,0,0
"DG_s08",4,8.047,8.719,10.454,10.469,10,10,28,4,0,82,1.735,0,28,4,24,0,-24
"DG_s08",5,11.469,12.141,13.125,13.141,10,10,22,6,0,76,0.984,0,22,6,16,0,-16
"DG_s08",7,17.813,18.485,19.547,19.547,28,4,10,10,24,76,1.062,1,28,4,24,0,-24
"DG_s08",9,24.219,24.891,26.235,26.235,13,7,10,10,6,76,1.344,1,13,7,6,0,-6
"DG_s08",10,27.235,27.907,29.391,29.391,10,10,10,26,0,76,1.484,0,10,26,16,16,0
"DG_s08",12,34.063,34.735,35.969,35.969,16,4,10,10,12,76,1.234,1,16,4,12,0,-12
"DG_s08",13,36.969,37.641,38.235,38.25,10,10,8,11,0,76,0.594,0,8,11,3,3,0
"DG_s08",14,39.25,39.922,40.766,40.766,18,18,10,10,0,76,0.844,1,18,18,0,0,0
"DG_s08",15,41.766,42.438,43.11,43.125,10,10,8,16,0,82,0.672,0,8,16,8,8,0
"DG_s08",17,47.797,48.469,48.735,48.735,10,10,6,6,0,76,0.266,0,6,6,0,0,0
"DG_s08",18,49.75,50.422,51.36,51.36,10,10,14,26,0,76,0.938,0,14,26,12,12,0
"DG_s08",19,52.375,53.047,53.672,53.672,10,10,11,7,0,82,0.625,0,11,7,4,0,-4
"DG_s08",20,54.672,55.344,56,56,16,4,10,10,12,76,0.656,1,16,4,12,0,-12
"DG_s08",21,57,57.672,58.219,58.235,10,10,13,1,0,76,0.547,0,13,1,12,0,-12
"DG_s08",23,62.907,63.579,64.469,64.469,10,10,6,11,0,82,0.89,0,6,11,5,5,0
"DG_s08",24,65.469,66.141,67.469,67.469,10,10,15,30,0,82,1.328,0,15,30,15,15,0
"DG_s08",25,68.469,69.141,70.563,70.563,18,10,10,10,8,76,1.422,1,18,10,8,0,-8
"DG_s08",26,71.563,72.235,73.454,73.469,6,14,10,10,8,82,1.219,1,6,14,8,8,0
"DG_s08",27,74.469,75.141,75.688,75.688,10,10,10,22,0,76,0.547,0,10,22,12,12,0
"DG_s08",28,76.688,77.36,77.922,77.938,10,10,30,10,0,76,0.562,0,30,10,20,0,-20
"DG_s08",29,78.938,79.61,80.5,80.5,18,12,10,10,6,76,0.89,1,18,12,6,0,-6
"DG_s08",30,81.5,82.172,82.625,82.625,18,10,10,10,8,76,0.453,1,18,10,8,0,-8
"DG_s08",31,83.625,84.297,85.438,85.454,10,10,13,1,0,76,1.141,0,13,1,12,0,-12
"DG_s08",32,86.454,87.125,88.157,88.157,10,10,16,8,0,82,1.032,0,16,8,8,0,-8
"DG_s08",34,92.829,93.5,94.782,94.782,22,13,10,10,9,82,1.282,1,22,13,9,0,-9
"DG_s08",35,95.782,96.454,97.641,97.641,10,10,8,16,0,76,1.187,0,8,16,8,8,0
"DG_s08",36,98.641,99.313,101.047,101.047,10,10,12,18,0,82,1.734,0,12,18,6,6,0
"DG_s08",37,102.047,102.719,103.625,103.625,12,4,10,10,8,76,0.906,1,12,4,8,0,-8
"DG_s08",38,104.625,105.297,106.547,106.563,10,10,14,26,0,82,1.25,0,14,26,12,12,0
"DG_s08",39,107.563,108.235,109.016,109.016,10,10,10,30,0,76,0.781,0,10,30,20,20,0
"DG_s08",40,110.016,110.688,112.172,112.172,14,14,10,10,0,82,1.484,1,14,14,0,0,0
"DG_s08",41,113.172,113.844,114.829,114.829,10,10,6,14,0,76,0.985,0,6,14,8,8,0
"DG_s08",42,115.829,116.5,117.266,117.266,10,10,6,11,0,76,0.766,0,6,11,5,5,0
"DG_s08",43,118.266,118.938,120.188,120.204,10,10,30,15,0,82,1.25,0,30,15,15,0,-15
"DG_s08",44,121.204,121.875,122.375,122.375,10,10,3,17,0,76,0.5,0,3,17,14,14,0
"DG_s08",45,123.375,124.047,125.235,125.25,13,7,10,10,6,76,1.188,1,13,7,6,0,-6
"DG_s08",46,126.25,126.922,127.829,127.844,10,10,12,18,0,76,0.907,0,12,18,6,6,0
"DG_s08",47,128.844,129.516,130.891,130.907,16,8,10,10,8,76,1.375,1,16,8,8,0,-8
"DG_s08",48,131.907,132.579,134.438,134.454,10,10,10,30,0,76,1.859,0,10,30,20,20,0
"DG_s08",49,135.454,136.125,137.688,137.688,18,12,10,10,6,76,1.563,1,18,12,6,0,-6
"DG_s08",50,138.688,139.36,140.188,140.188,2,2,10,10,0,82,0.828,1,2,2,0,0,0
"DG_s08",51,141.188,141.86,142.563,142.563,10,10,3,31,0,76,0.703,0,3,31,28,28,0
"DG_s08",52,143.563,144.235,145.375,145.375,10,22,10,10,12,76,1.14,1,10,22,12,12,0
"DG_s08",53,146.375,147.047,147.704,147.704,10,10,26,10,0,76,0.657,0,26,10,16,0,-16
"DG_s08",54,148.704,149.375,150.813,150.813,30,10,10,10,20,76,1.438,1,30,10,20,0,-20
"DG_s08",55,151.813,152.485,153.688,153.688,10,10,6,22,0,82,1.203,0,6,22,16,16,0
"DG_s08",56,154.704,155.375,156.157,156.157,10,10,10,18,0,76,0.782,0,10,18,8,8,0
"DG_s08",57,157.157,157.829,159.36,159.36,10,10,13,22,0,82,1.531,0,13,22,9,9,0
"DG_s08",58,160.36,161.032,161.969,161.969,3,31,10,10,28,82,0.937,1,3,31,28,28,0
"DG_s08",59,162.969,163.641,164.172,164.172,10,10,26,14,0,76,0.531,0,26,14,12,0,-12
"DG_s08",60,165.172,165.844,166.391,166.391,10,10,18,2,0,76,0.547,0,18,2,16,0,-16
"DG_s08",61,167.391,168.063,168.922,168.922,16,16,10,10,0,76,0.859,1,16,16,0,0,0
"DG_s08",62,169.922,170.594,171.469,171.469,10,10,8,11,0,76,0.875,0,8,11,3,3,0
"DG_s08",63,172.469,173.141,173.672,173.672,10,10,10,26,0,76,0.531,0,10,26,16,16,0
"DG_s08",64,174.688,175.36,176.641,176.641,10,10,15,30,0,82,1.281,0,15,30,15,15,0
"DG_s08",65,177.641,178.313,179.61,179.61,10,10,22,10,0,82,1.297,0,22,10,12,0,-12
"DG_s08",66,180.61,181.282,182.813,182.813,10,10,12,4,0,82,1.531,0,12,4,8,0,-8
"DG_s08",67,183.813,184.485,185.204,185.204,10,10,26,14,0,76,0.719,0,26,14,12,0,-12
"DG_s08",68,186.204,186.875,187.954,187.954,10,10,22,6,0,82,1.079,0,22,6,16,0,-16
"DG_s08",69,188.954,189.625,190.594,190.594,10,10,6,22,0,82,0.969,0,6,22,16,16,0
"DG_s08",70,191.594,192.266,193.016,193.016,10,10,8,12,0,76,0.75,0,8,12,4,4,0
"DG_s08",71,194.032,194.704,195.469,195.485,10,10,3,12,0,82,0.765,0,3,12,9,9,0
"DG_s08",72,196.485,197.157,198.063,198.063,10,10,18,2,0,82,0.906,0,18,2,16,0,-16
"DG_s08",73,199.063,199.735,200.61,200.61,10,10,22,10,0,76,0.875,0,22,10,12,0,-12
"DG_s08",74,201.61,202.282,204.079,204.079,22,13,10,10,9,76,1.797,1,22,13,9,0,-9
"DG_s08",75,205.079,205.75,206.579,206.579,10,10,8,12,0,76,0.829,0,8,12,4,4,0
"DG_s08",76,207.579,208.25,208.938,208.938,10,10,3,12,0,76,0.688,0,3,12,9,9,0
"DG_s08",77,209.938,210.61,211.829,211.829,10,18,10,10,8,82,1.219,1,10,18,8,8,0
"DG_s08",78,212.829,213.5,214.829,214.844,12,12,10,10,0,76,1.329,1,12,12,0,0,0
"DG_s08",79,215.844,216.516,218.047,218.047,8,8,10,10,0,82,1.531,1,8,8,0,0,0
"DG_s08",80,219.063,219.735,221.063,221.063,28,4,10,10,24,76,1.328,1,28,4,24,0,-24
"DG_s08",81,222.079,222.75,223.75,223.75,10,10,22,6,0,76,1,0,22,6,16,0,-16
"DG_s08",82,224.75,225.422,226.532,226.547,30,15,10,10,15,76,1.11,1,30,15,15,0,-15
"DG_s08",83,227.547,228.219,228.891,228.907,28,4,10,10,24,76,0.672,1,28,4,24,0,-24
"DG_s08",84,229.907,230.579,231.235,231.25,10,10,4,4,0,76,0.656,0,4,4,0,0,0
"DG_s08",85,232.25,232.922,233.485,233.5,13,7,10,10,6,76,0.563,1,13,7,6,0,-6
"DG_s08",86,234.5,235.172,236.922,236.922,10,10,10,26,0,76,1.75,0,10,26,16,16,0
"DG_s08",87,237.922,238.594,239.25,239.25,10,10,13,22,0,76,0.656,0,13,22,9,9,0
"DG_s08",88,240.25,240.922,241.735,241.735,16,4,10,10,12,76,0.813,1,16,4,12,0,-12
"DG_s08",89,242.735,243.407,243.954,243.954,10,10,8,11,0,76,0.547,0,8,11,3,3,0
"DG_s08",90,244.954,245.625,246.5,246.5,18,18,10,10,0,76,0.875,1,18,18,0,0,0
"DG_s08",91,247.5,248.172,249.75,249.75,10,10,8,16,0,82,1.578,0,8,16,8,8,0
"DG_s08",92,250.766,251.438,252.016,252.016,10,10,3,17,0,76,0.578,0,3,17,14,14,0
"DG_s08",93,253.032,253.704,254.204,254.204,10,10,6,6,0,76,0.5,0,6,6,0,0,0
"DG_s08",94,255.204,255.875,256.454,256.454,10,10,14,26,0,76,0.579,0,14,26,12,12,0
"DG_s08",95,257.454,258.125,258.625,258.625,11,7,10,10,4,76,0.5,1,11,7,4,0,-4
"DG_s08",96,259.625,260.297,261.266,261.266,16,4,10,10,12,76,0.969,1,16,4,12,0,-12
"DG_s08",97,262.266,262.938,263.485,263.5,10,10,13,1,0,76,0.547,0,13,1,12,0,-12
"DG_s08",98,264.5,265.172,266.141,266.141,11,7,10,10,4,76,0.969,1,11,7,4,0,-4
"DG_s08",99,267.141,267.813,268.735,268.735,10,10,6,11,0,82,0.922,0,6,11,5,5,0
"DG_s08",100,269.735,270.407,271.11,271.11,15,30,10,10,15,76,0.703,1,15,30,15,15,0
"DG_s08",101,272.11,272.782,273.735,273.735,10,10,18,10,0,82,0.953,0,18,10,8,0,-8
"DG_s08",102,274.735,275.407,275.969,275.969,10,10,6,14,0,76,0.562,0,6,14,8,8,0
"DG_s08",103,276.969,277.641,278.469,278.485,10,10,10,22,0,76,0.828,0,10,22,12,12,0
"DG_s08",104,279.485,280.157,280.704,280.704,10,10,30,10,0,76,0.547,0,30,10,20,0,-20
"DG_s08",105,281.719,282.391,283.625,283.625,18,12,10,10,6,76,1.234,1,18,12,6,0,-6
"DG_s08",107,288.297,288.969,289.969,289.969,13,1,10,10,12,82,1,1,13,1,12,0,-12
"DG_s08",108,290.969,291.641,292.969,292.969,16,8,10,10,8,76,1.328,1,16,8,8,0,-8
"DG_s08",109,293.969,294.641,295.782,295.782,26,10,10,10,16,76,1.141,1,26,10,16,0,-16
"DG_s08",110,296.782,297.454,298.375,298.375,22,13,10,10,9,82,0.921,1,22,13,9,0,-9
"DG_s08",111,299.391,300.063,300.844,300.844,10,10,8,16,0,76,0.781,0,8,16,8,8,0
"DG_s08",113,305.516,306.188,306.829,306.829,12,4,10,10,8,76,0.641,1,12,4,8,0,-8
"DG_s08",114,307.829,308.5,309.579,309.594,14,26,10,10,12,76,1.079,1,14,26,12,12,0
"DG_s08",115,310.594,311.266,312.141,312.157,10,10,10,30,0,76,0.875,0,10,30,20,20,0
"DG_s08",116,313.157,313.829,314.61,314.61,10,10,14,14,0,76,0.781,0,14,14,0,0,0
"DG_s08",118,319.282,319.954,320.532,320.532,10,10,6,11,0,76,0.578,0,6,11,5,5,0
"DG_s08",119,321.532,322.204,323.219,323.219,30,15,10,10,15,76,1.015,1,30,15,15,0,-15
"DG_s08",120,324.219,324.891,325.969,325.969,10,10,3,17,0,76,1.078,0,3,17,14,14,0
"DG_s08",121,326.969,327.641,329.485,329.5,13,7,10,10,6,76,1.844,1,13,7,6,0,-6
"DG_s08",122,330.5,331.172,333,333,10,10,12,18,0,76,1.828,0,12,18,6,6,0
"DG_s08",123,334.016,334.688,335.75,335.75,16,8,10,10,8,76,1.062,1,16,8,8,0,-8
"DG_s08",124,336.75,337.422,339.063,339.063,10,10,10,30,0,76,1.641,0,10,30,20,20,0
"DG_s08",125,340.063,340.735,341.563,341.579,18,12,10,10,6,76,0.828,1,18,12,6,0,-6
"DG_s08",126,342.579,343.25,344.016,344.016,10,10,2,2,0,76,0.766,0,2,2,0,0,0
"DG_s08",127,345.032,345.704,347.516,347.532,10,10,3,31,0,76,1.812,0,3,31,28,28,0
"DG_s08",128,348.532,349.204,350.75,350.75,10,22,10,10,12,76,1.546,1,10,22,12,12,0
"DG_s08",129,351.75,352.422,353.25,353.266,26,10,10,10,16,82,0.828,1,26,10,16,0,-16
"DG_s08",130,354.266,354.938,355.938,355.938,30,10,10,10,20,76,1,1,30,10,20,0,-20
"DG_s08",131,356.938,357.61,359.5,359.516,10,10,6,22,0,82,1.89,0,6,22,16,16,0
"DG_s08",132,360.516,361.188,362.204,362.219,10,10,10,18,0,76,1.016,0,10,18,8,8,0
"DG_s08",134,366.891,367.563,368.016,368.016,3,31,10,10,28,82,0.453,1,3,31,28,28,0
"DG_s08",135,369.016,369.688,370.579,370.594,10,10,26,14,0,76,0.891,0,26,14,12,0,-12
"DG_s08",136,371.594,372.266,373.829,373.829,10,10,18,2,0,76,1.563,0,18,2,16,0,-16
"DG_s08",137,374.829,375.5,376.641,376.641,16,16,10,10,0,76,1.141,1,16,16,0,0,0
"DG_s08",141,388.657,389.329,391.141,391.157,22,10,10,10,12,76,1.812,1,22,10,12,0,-12
"DG_s08",143,395.829,396.5,397.454,397.469,10,10,26,14,0,76,0.954,0,26,14,12,0,-12
"DG_s08",144,398.469,399.141,400.047,400.047,22,6,10,10,16,76,0.906,1,22,6,16,0,-16
"DG_s08",145,401.063,401.735,403.375,403.375,6,22,10,10,16,76,1.64,1,6,22,16,16,0
"DG_s08",146,404.391,405.063,406.204,406.219,8,12,10,10,4,82,1.141,1,8,12,4,4,0
"DG_s08",147,407.219,407.891,408.782,408.797,10,10,3,12,0,82,0.891,0,3,12,9,9,0
"DG_s08",148,409.797,410.469,411.094,411.11,18,2,10,10,16,76,0.625,1,18,2,16,0,-16
"DG_s08",149,412.11,412.782,413.547,413.563,22,10,10,10,12,82,0.765,1,22,10,12,0,-12
"DG_s08",150,414.563,415.235,415.875,415.891,22,13,10,10,9,76,0.64,1,22,13,9,0,-9
"DG_s08",151,416.891,417.563,418.25,418.25,10,10,8,12,0,76,0.687,0,8,12,4,4,0
"DG_s08",152,419.25,419.922,420.547,420.547,10,10,3,12,0,76,0.625,0,3,12,9,9,0
"DG_s08",153,421.547,422.219,423,423,10,10,10,18,0,76,0.781,0,10,18,8,8,0
"DG_s08",155,427.672,428.344,428.954,428.954,10,10,8,8,0,76,0.61,0,8,8,0,0,0
"DG_s08",156,429.954,430.625,431.282,431.282,28,4,10,10,24,76,0.657,1,28,4,24,0,-24
"DG_s08",157,432.282,432.954,433.735,433.735,22,6,10,10,16,82,0.781,1,22,6,16,0,-16
"DG_s08",158,434.75,435.422,436.016,436.016,30,15,10,10,15,76,0.594,1,30,15,15,0,-15
"DG_s08",159,437.016,437.688,438.297,438.297,28,4,10,10,24,76,0.609,1,28,4,24,0,-24
"DG_s08",160,439.297,439.969,440.719,440.719,10,10,4,4,0,76,0.75,0,4,4,0,0,0
"DG_s08",161,441.719,442.391,444.016,444.016,13,7,10,10,6,76,1.625,1,13,7,6,0,-6
"DG_s08",162,445.032,445.704,447.516,447.532,10,10,10,26,0,76,1.812,0,10,26,16,16,0
"DG_s08",163,448.532,449.204,450.11,450.125,10,10,13,22,0,76,0.906,0,13,22,9,9,0
"DG_s08",164,451.125,451.797,452.36,452.36,16,4,10,10,12,76,0.563,1,16,4,12,0,-12
"DG_s08",165,453.375,454.047,455.5,455.516,10,10,8,11,0,76,1.453,0,8,11,3,3,0
"DG_s08",166,456.516,457.188,458,458,18,18,10,10,0,76,0.812,1,18,18,0,0,0
"DG_s08",167,459,459.672,460.922,460.922,10,10,8,16,0,82,1.25,0,8,16,8,8,0
"DG_s08",168,461.922,462.594,463.204,463.204,10,10,3,17,0,76,0.61,0,3,17,14,14,0
"DG_s08",169,464.204,464.875,465.469,465.469,10,10,6,6,0,76,0.594,0,6,6,0,0,0
"DG_s08",170,466.469,467.141,467.641,467.641,10,10,14,26,0,76,0.5,0,14,26,12,12,0
"DG_s08",171,468.641,469.313,470.516,470.532,10,10,11,7,0,82,1.203,0,11,7,4,0,-4
"DG_s08",172,471.532,472.204,473.438,473.454,10,10,16,4,0,82,1.234,0,16,4,12,0,-12
"DG_s08",173,474.454,475.125,475.735,475.735,10,10,13,1,0,76,0.61,0,13,1,12,0,-12
"DG_s08",174,476.75,477.422,478.985,478.985,10,10,11,7,0,82,1.563,0,11,7,4,0,-4
"DG_s08",175,479.985,480.657,481.407,481.407,6,11,10,10,5,76,0.75,1,6,11,5,5,0
"DG_s08",176,482.407,483.079,483.797,483.813,10,10,15,30,0,82,0.718,0,15,30,15,15,0
"DG_s08",177,484.813,485.485,486.407,486.407,10,10,18,10,0,82,0.922,0,18,10,8,0,-8
"DG_s08",178,487.407,488.079,488.688,488.688,10,10,6,14,0,76,0.609,0,6,14,8,8,0
"DG_s08",179,489.704,490.375,491.094,491.094,10,10,10,22,0,76,0.719,0,10,22,12,12,0
"DG_s08",180,492.11,492.782,494.063,494.063,30,10,10,10,20,82,1.281,1,30,10,20,0,-20
"DG_s08",182,498.75,499.422,500.36,500.36,18,10,10,10,8,76,0.938,1,18,10,8,0,-8
"DG_s08",183,501.375,502.047,503.25,503.25,13,1,10,10,12,82,1.203,1,13,1,12,0,-12
"DG_s08",185,507.922,508.594,509.375,509.375,26,10,10,10,16,76,0.781,1,26,10,16,0,-16
"DG_s08",186,510.391,511.063,511.735,511.735,22,13,10,10,9,82,0.672,1,22,13,9,0,-9
"DG_s08",187,512.75,513.422,514.094,514.11,10,10,8,16,0,76,0.672,0,8,16,8,8,0
"DG_s08",188,515.11,515.782,517.204,517.204,12,18,10,10,6,76,1.422,1,12,18,6,6,0
"DG_s08",189,518.204,518.875,520.032,520.032,10,10,12,4,0,82,1.157,0,12,4,8,0,-8
"DG_s08",190,521.032,521.704,522.375,522.375,14,26,10,10,12,76,0.671,1,14,26,12,12,0
"DG_s08",191,523.391,524.063,524.891,524.891,10,10,10,30,0,76,0.828,0,10,30,20,20,0
"DG_s08",192,525.891,526.563,527.297,527.297,10,10,14,14,0,76,0.734,0,14,14,0,0,0
"DG_s08",193,528.297,528.969,529.86,529.875,10,10,6,14,0,76,0.891,0,6,14,8,8,0
"DG_s08",194,530.875,531.547,532.454,532.454,10,10,6,11,0,76,0.907,0,6,11,5,5,0
"DG_s08",195,533.454,534.125,535.172,535.188,30,15,10,10,15,76,1.047,1,30,15,15,0,-15
"DG_s08",196,536.188,536.86,538.719,538.719,10,10,3,17,0,76,1.859,0,3,17,14,14,0
"DG_s08",197,539.719,540.391,542.266,542.266,10,10,13,7,0,82,1.875,0,13,7,6,0,-6
"DG_s08",198,543.266,543.938,544.61,544.61,10,10,12,18,0,76,0.672,0,12,18,6,6,0
"DG_s08",199,545.61,546.282,547.469,547.469,16,8,10,10,8,76,1.187,1,16,8,8,0,-8
"DG_s08",200,548.469,549.141,550.329,550.329,10,10,10,30,0,76,1.188,0,10,30,20,20,0
"DG_s08",201,551.329,552,552.969,552.969,18,12,10,10,6,76,0.969,1,18,12,6,0,-6
"DG_s08",202,553.969,554.641,555.282,555.282,10,10,2,2,0,76,0.641,0,2,2,0,0,0
"DG_s08",203,556.282,556.954,557.532,557.547,10,10,3,31,0,76,0.578,0,3,31,28,28,0
"DG_s08",205,562.219,562.891,564.25,564.266,10,10,26,10,0,76,1.359,0,26,10,16,0,-16
"DG_s08",206,565.266,565.938,566.5,566.516,30,10,10,10,20,76,0.562,1,30,10,20,0,-20
"DG_s08",207,567.516,568.188,569.672,569.672,10,10,6,22,0,82,1.484,0,6,22,16,16,0
"DG_s08",208,570.672,571.344,572.032,572.032,10,10,10,18,0,76,0.688,0,10,18,8,8,0
"DG_s08",209,573.047,573.719,575.422,575.422,10,10,13,22,0,82,1.703,0,13,22,9,9,0
"DG_s08",210,576.422,577.094,577.657,577.657,10,10,3,31,0,76,0.563,0,3,31,28,28,0
"DG_s08",211,578.657,579.329,579.844,579.86,10,10,26,14,0,76,0.515,0,26,14,12,0,-12
"DG_s08",212,580.86,581.532,582.11,582.125,10,10,18,2,0,76,0.578,0,18,2,16,0,-16
"DG_s08",213,583.125,583.797,584.657,584.657,16,16,10,10,0,76,0.86,1,16,16,0,0,0
"DG_s08",214,585.657,586.329,586.875,586.875,10,10,8,11,0,76,0.546,0,8,11,3,3,0
"DG_s08",215,587.875,588.547,589.032,589.032,10,10,10,26,0,76,0.485,0,10,26,16,16,0
"DG_s08",216,590.047,590.719,592.094,592.11,10,10,15,30,0,82,1.375,0,15,30,15,15,0
"DG_s08",217,593.11,593.782,594.625,594.625,22,10,10,10,12,76,0.843,1,22,10,12,0,-12
"DG_s08",218,595.625,596.297,597.141,597.141,10,10,12,4,0,82,0.844,0,12,4,8,0,-8
"DG_s08",219,598.141,598.813,599.469,599.485,10,10,26,14,0,76,0.656,0,26,14,12,0,-12
"DG_s08",220,600.485,601.157,601.641,601.641,22,6,10,10,16,76,0.484,1,22,6,16,0,-16
"DG_s08",221,602.641,603.313,604.141,604.141,10,10,6,22,0,82,0.828,0,6,22,16,16,0
"DG_s08",222,605.141,605.813,606.438,606.438,10,10,8,12,0,76,0.625,0,8,12,4,4,0
"DG_s08",223,607.438,608.11,608.704,608.704,10,10,3,12,0,82,0.594,0,3,12,9,9,0
"DG_s08",224,609.704,610.375,611.141,611.157,18,2,10,10,16,76,0.766,1,18,2,16,0,-16
"DG_s08",225,612.157,612.829,613.313,613.313,22,10,10,10,12,82,0.484,1,22,10,12,0,-12
"DG_s08",226,614.313,614.985,615.5,615.516,22,13,10,10,9,76,0.515,1,22,13,9,0,-9
"DG_s08",227,616.516,617.188,618.344,618.344,10,10,8,12,0,76,1.156,0,8,12,4,4,0
"DG_s08",228,619.344,620.016,620.782,620.782,10,10,3,12,0,76,0.766,0,3,12,9,9,0
"DG_s09",2,3,3.625,4.797,4.797,12,12,10,10,0,76,1.172,1,12,12,0,0,0
"DG_s09",3,5.797,6.422,7.688,7.688,10,10,8,8,0,76,1.266,0,8,8,0,0,0
"DG_s09",4,8.688,9.313,10.234,10.234,28,4,10,10,24,76,0.921,1,28,4,24,0,-24
"DG_s09",5,11.234,11.844,12.781,12.781,22,6,10,10,16,82,0.937,1,22,6,16,0,-16
"DG_s09",6,13.781,14.391,14.969,14.969,30,15,10,10,15,76,0.578,1,30,15,15,0,-15
"DG_s09",7,15.969,16.594,17.328,17.328,28,4,10,10,24,76,0.734,1,28,4,24,0,-24
"DG_s09",8,18.328,18.938,19.734,19.75,10,10,4,4,0,76,0.796,0,4,4,0,0,0
"DG_s09",9,20.75,21.375,22.234,22.234,13,7,10,10,6,76,0.859,1,13,7,6,0,-6
"DG_s09",10,23.234,23.844,25.734,25.75,10,10,10,26,0,76,1.89,0,10,26,16,16,0
"DG_s09",11,26.75,27.375,29.063,29.078,10,10,13,22,0,76,1.688,0,13,22,9,9,0
"DG_s09",12,30.078,30.688,31.703,31.703,16,4,10,10,12,76,1.015,1,16,4,12,0,-12
"DG_s09",13,32.703,33.313,35.078,35.078,10,10,8,11,0,76,1.765,0,8,11,3,3,0
"DG_s09",14,36.078,36.688,37.844,37.859,18,18,10,10,0,76,1.156,1,18,18,0,0,0
"DG_s09",15,38.859,39.469,40.953,40.953,10,10,8,16,0,82,1.484,0,8,16,8,8,0
"DG_s09",16,41.953,42.563,43.828,43.844,10,10,3,17,0,76,1.265,0,3,17,14,14,0
"DG_s09",17,44.844,45.469,46.781,46.781,10,10,6,6,0,76,1.312,0,6,6,0,0,0
"DG_s09",18,47.781,48.391,49.828,49.844,10,10,14,26,0,76,1.437,0,14,26,12,12,0
"DG_s09",19,50.844,51.469,52.953,52.953,11,7,10,10,4,76,1.484,1,11,7,4,0,-4
"DG_s09",20,53.953,54.563,56.141,56.141,16,4,10,10,12,76,1.578,1,16,4,12,0,-12
"DG_s09",21,57.141,57.766,58.672,58.672,13,1,10,10,12,82,0.906,1,13,1,12,0,-12
"DG_s09",22,59.688,60.313,61.703,61.703,11,7,10,10,4,76,1.39,1,11,7,4,0,-4
"DG_s09",23,62.703,63.313,64.797,64.797,10,10,6,11,0,82,1.484,0,6,11,5,5,0
"DG_s09",24,65.797,66.422,68.156,68.156,10,10,15,30,0,82,1.734,0,15,30,15,15,0
"DG_s09",25,69.156,69.766,71.391,71.406,18,10,10,10,8,76,1.625,1,18,10,8,0,-8
"DG_s09",27,76.016,76.641,77.656,77.656,10,10,10,22,0,76,1.015,0,10,22,12,12,0
"DG_s09",28,78.656,79.266,80.516,80.516,30,10,10,10,20,82,1.25,1,30,10,20,0,-20
"DG_s09",29,81.516,82.141,83.094,83.094,18,12,10,10,6,76,0.953,1,18,12,6,0,-6
"DG_s09",30,84.094,84.719,85.578,85.578,18,10,10,10,8,76,0.859,1,18,10,8,0,-8
"DG_s09",31,86.578,87.188,88,88,13,1,10,10,12,82,0.812,1,13,1,12,0,-12
"DG_s09",32,89,89.625,90.484,90.484,16,8,10,10,8,76,0.859,1,16,8,8,0,-8
"DG_s09",33,91.484,92.094,92.953,92.953,26,10,10,10,16,76,0.859,1,26,10,16,0,-16
"DG_s09",34,93.953,94.563,95.344,95.344,22,13,10,10,9,82,0.781,1,22,13,9,0,-9
"DG_s09",35,96.359,96.969,98,98,10,10,8,16,0,76,1.031,0,8,16,8,8,0
"DG_s09",36,99,99.625,101.078,101.078,12,18,10,10,6,76,1.453,1,12,18,6,6,0
"DG_s09",37,102.078,102.688,104.313,104.313,12,4,10,10,8,76,1.625,1,12,4,8,0,-8
"DG_s09",38,105.328,105.938,106.875,106.891,10,10,14,26,0,82,0.937,0,14,26,12,12,0
"DG_s09",39,107.891,108.516,110.063,110.063,10,10,10,30,0,76,1.547,0,10,30,20,20,0
"DG_s09",40,111.063,111.688,113.531,113.531,14,14,10,10,0,82,1.843,1,14,14,0,0,0
"DG_s09",41,114.531,115.141,117.031,117.031,10,10,6,14,0,76,1.89,0,6,14,8,8,0
"DG_s09",42,118.031,118.641,119.906,119.906,10,10,6,11,0,76,1.265,0,6,11,5,5,0
"DG_s09",43,120.906,121.516,122.875,122.875,30,15,10,10,15,76,1.359,1,30,15,15,0,-15
"DG_s09",44,123.875,124.5,125.984,125.984,10,10,3,17,0,76,1.484,0,3,17,14,14,0
"DG_s09",45,126.984,127.594,128.922,128.922,13,7,10,10,6,76,1.328,1,13,7,6,0,-6
"DG_s09",46,129.922,130.547,131.922,131.922,10,10,12,18,0,76,1.375,0,12,18,6,6,0
"DG_s09",47,132.922,133.547,135.172,135.188,16,8,10,10,8,76,1.625,1,16,8,8,0,-8
"DG_s09",48,136.188,136.813,138.188,138.188,10,10,10,30,0,76,1.375,0,10,30,20,20,0
"DG_s09",49,139.188,139.813,140.719,140.719,18,12,10,10,6,76,0.906,1,18,12,6,0,-6
"DG_s09",50,141.719,142.344,143.938,143.938,10,10,2,2,0,76,1.594,0,2,2,0,0,0
"DG_s09",51,144.938,145.563,147.531,147.547,10,10,3,31,0,76,1.968,0,3,31,28,28,0
"DG_s09",52,148.547,149.172,150.594,150.594,10,10,10,22,0,82,1.422,0,10,22,12,12,0
"DG_s09",53,151.594,152.219,153.125,153.141,26,10,10,10,16,82,0.906,1,26,10,16,0,-16
"DG_s09",54,154.141,154.766,155.703,155.703,30,10,10,10,20,76,0.937,1,30,10,20,0,-20
"DG_s09",55,156.703,157.313,158.688,158.688,10,10,6,22,0,82,1.375,0,6,22,16,16,0
"DG_s09",56,159.688,160.313,161.859,161.875,10,10,10,18,0,76,1.546,0,10,18,8,8,0
"DG_s09",57,162.875,163.5,164.719,164.719,10,10,13,22,0,82,1.219,0,13,22,9,9,0
"DG_s09",58,165.719,166.344,167.375,167.375,10,10,3,31,0,76,1.031,0,3,31,28,28,0
"DG_s09",59,168.391,169.016,169.984,169.984,26,14,10,10,12,82,0.968,1,26,14,12,0,-12
"DG_s09",60,170.984,171.594,172.844,172.859,18,2,10,10,16,82,1.25,1,18,2,16,0,-16
"DG_s09",61,173.859,174.469,175.969,175.969,16,16,10,10,0,76,1.5,1,16,16,0,0,0
"DG_s09",62,176.969,177.594,178.797,178.813,10,10,8,11,0,76,1.203,0,8,11,3,3,0
"DG_s09",63,179.813,180.438,181.391,181.391,10,10,10,26,0,76,0.953,0,10,26,16,16,0
"DG_s09",64,182.406,183.016,184,184,10,10,15,30,0,82,0.984,0,15,30,15,15,0
"DG_s09",65,185,185.625,186.547,186.547,22,10,10,10,12,76,0.922,1,22,10,12,0,-12
"DG_s09",66,187.547,188.172,189.188,189.188,10,10,12,4,0,82,1.016,0,12,4,8,0,-8
"DG_s09",67,190.188,190.813,192.266,192.266,26,14,10,10,12,82,1.453,1,26,14,12,0,-12
"DG_s09",68,193.266,193.891,195.125,195.141,22,6,10,10,16,76,1.234,1,22,6,16,0,-16
"DG_s09",69,196.141,196.766,198.078,198.094,10,10,6,22,0,82,1.312,0,6,22,16,16,0
"DG_s09",70,199.094,199.719,201.109,201.109,10,10,8,12,0,76,1.39,0,8,12,4,4,0
"DG_s09",71,202.109,202.719,204,204,10,10,3,12,0,82,1.281,0,3,12,9,9,0
"DG_s09",72,205.016,205.641,206.625,206.625,18,2,10,10,16,76,0.984,1,18,2,16,0,-16
"DG_s09",73,207.625,208.25,209.203,209.219,22,10,10,10,12,82,0.953,1,22,10,12,0,-12
"DG_s09",74,210.219,210.844,211.594,211.594,22,13,10,10,9,76,0.75,1,22,13,9,0,-9
"DG_s09",75,212.594,213.219,214.547,214.547,10,10,8,12,0,76,1.328,0,8,12,4,4,0
"DG_s09",76,215.547,216.172,217.344,217.344,10,10,3,12,0,76,1.172,0,3,12,9,9,0
"DG_s09",77,218.344,218.969,220.203,220.203,10,10,10,18,0,76,1.234,0,10,18,8,8,0
"DG_s09",78,221.203,221.813,222.906,222.906,12,12,10,10,0,76,1.093,1,12,12,0,0,0
"DG_s09",79,223.906,224.516,225.844,225.859,10,10,8,8,0,76,1.328,0,8,8,0,0,0
"DG_s09",80,226.859,227.469,228.406,228.406,28,4,10,10,24,76,0.937,1,28,4,24,0,-24
"DG_s09",81,229.406,230.016,230.875,230.891,22,6,10,10,16,82,0.859,1,22,6,16,0,-16
"DG_s09",82,231.891,232.516,233.406,233.406,30,15,10,10,15,76,0.89,1,30,15,15,0,-15
"DG_s09",83,234.406,235.016,236.031,236.031,28,4,10,10,24,76,1.015,1,28,4,24,0,-24
"DG_s09",84,237.031,237.641,238.688,238.688,10,10,4,4,0,76,1.047,0,4,4,0,0,0
"DG_s09",85,239.703,240.313,241.5,241.5,13,7,10,10,6,76,1.187,1,13,7,6,0,-6
"DG_s09",86,242.5,243.125,244.781,244.781,10,10,10,26,0,76,1.656,0,10,26,16,16,0
"DG_s09",87,245.781,246.391,248.078,248.094,10,10,13,22,0,76,1.687,0,13,22,9,9,0
"DG_s09",88,249.094,249.719,250.672,250.672,16,4,10,10,12,76,0.953,1,16,4,12,0,-12
"DG_s09",89,251.688,252.313,253.594,253.594,10,10,8,11,0,76,1.281,0,8,11,3,3,0
"DG_s09",90,254.594,255.219,256.609,256.609,18,18,10,10,0,76,1.39,1,18,18,0,0,0
"DG_s09",91,257.609,258.219,259.484,259.484,10,10,8,16,0,82,1.265,0,8,16,8,8,0
"DG_s09",92,260.484,261.094,262.297,262.297,10,10,3,17,0,76,1.203,0,3,17,14,14,0
"DG_s09",93,263.297,263.922,264.656,264.656,10,10,6,6,0,76,0.734,0,6,6,0,0,0
"DG_s09",94,265.656,266.266,267.703,267.703,10,10,14,26,0,76,1.437,0,14,26,12,12,0
"DG_s09",95,268.703,269.313,270.734,270.734,11,7,10,10,4,76,1.421,1,11,7,4,0,-4
"DG_s09",96,271.734,272.344,273.375,273.375,16,4,10,10,12,76,1.031,1,16,4,12,0,-12
"DG_s09",97,274.391,275.016,276.188,276.203,13,1,10,10,12,82,1.172,1,13,1,12,0,-12
"DG_s09",98,277.203,277.813,279.375,279.375,11,7,10,10,4,76,1.562,1,11,7,4,0,-4
"DG_s09",99,280.391,281.016,282.141,282.141,10,10,6,11,0,82,1.125,0,6,11,5,5,0
"DG_s09",100,283.141,283.766,284.813,284.813,10,10,15,30,0,82,1.047,0,15,30,15,15,0
"DG_s09",101,285.813,286.438,287.578,287.578,18,10,10,10,8,76,1.14,1,18,10,8,0,-8
"DG_s09",102,288.578,289.188,290.906,290.922,10,10,6,14,0,76,1.718,0,6,14,8,8,0
"DG_s09",103,291.922,292.547,293.172,293.188,10,10,10,22,0,76,0.625,0,10,22,12,12,0
"DG_s09",104,294.188,294.813,295.547,295.563,30,10,10,10,20,82,0.734,1,30,10,20,0,-20
"DG_s09",105,296.563,297.188,298.734,298.734,18,12,10,10,6,76,1.546,1,18,12,6,0,-6
"DG_s09",106,299.734,300.344,301.281,301.281,18,10,10,10,8,76,0.937,1,18,10,8,0,-8
"DG_s09",107,302.281,302.891,303.703,303.703,13,1,10,10,12,82,0.812,1,13,1,12,0,-12
"DG_s09",108,304.703,305.313,306.391,306.391,16,8,10,10,8,76,1.078,1,16,8,8,0,-8
"DG_s09",109,307.391,308.016,309.953,309.953,26,10,10,10,16,76,1.937,1,26,10,16,0,-16
"DG_s09",110,310.953,311.563,312.531,312.531,22,13,10,10,9,82,0.968,1,22,13,9,0,-9
"DG_s09",111,313.531,314.141,315.375,315.375,10,10,8,16,0,76,1.234,0,8,16,8,8,0
"DG_s09",112,316.391,317.016,318.141,318.156,10,10,12,18,0,82,1.125,0,12,18,6,6,0
"DG_s09",113,319.156,319.766,321.672,321.672,12,4,10,10,8,76,1.906,1,12,4,8,0,-8
"DG_s09",114,322.672,323.297,324.781,324.781,10,10,14,26,0,82,1.484,0,14,26,12,12,0
"DG_s09",115,325.781,326.391,328.313,328.313,10,10,10,30,0,76,1.922,0,10,30,20,20,0
"DG_s09",116,329.313,329.938,331.219,331.219,14,14,10,10,0,82,1.281,1,14,14,0,0,0
"DG_s09",117,332.219,332.844,333.844,333.844,10,10,6,14,0,76,NA,0,6,14,8,8,0
"DG_s09",118,334.844,335.469,336.453,336.469,10,10,6,11,0,76,0.984,0,6,11,5,5,0
"DG_s09",119,337.469,338.094,339.656,339.656,30,15,10,10,15,76,1.562,1,30,15,15,0,-15
"DG_s09",120,340.656,341.266,342.703,342.703,10,10,3,17,0,76,1.437,0,3,17,14,14,0
"DG_s09",121,343.719,344.344,345.875,345.891,13,7,10,10,6,76,1.531,1,13,7,6,0,-6
"DG_s09",122,346.891,347.516,348.781,348.797,10,10,12,18,0,76,1.265,0,12,18,6,6,0
"DG_s09",123,349.797,350.422,352,352,16,8,10,10,8,76,1.578,1,16,8,8,0,-8
"DG_s09",124,353,353.625,355.484,355.484,10,10,10,30,0,76,1.859,0,10,30,20,20,0
"DG_s09",125,356.484,357.094,358.75,358.75,18,12,10,10,6,76,1.656,1,18,12,6,0,-6
"DG_s09",126,359.766,360.391,362.203,362.203,2,2,10,10,0,82,1.812,1,2,2,0,0,0
"DG_s09",127,363.203,363.813,365.703,365.703,10,10,3,31,0,76,1.89,0,3,31,28,28,0
"DG_s09",129,370.344,370.969,372.578,372.594,10,10,26,10,0,76,1.609,0,26,10,16,0,-16
"DG_s09",130,373.594,374.219,375.469,375.469,30,10,10,10,20,76,1.25,1,30,10,20,0,-20
"DG_s09",131,376.469,377.094,378.344,378.344,10,10,6,22,0,82,1.25,0,6,22,16,16,0
"DG_s09",132,379.344,379.969,381.094,381.094,10,10,10,18,0,76,1.125,0,10,18,8,8,0
"DG_s09",133,382.094,382.719,384.297,384.297,10,10,13,22,0,82,1.578,0,13,22,9,9,0
"DG_s09",134,385.297,385.922,387.125,387.141,10,10,3,31,0,76,1.203,0,3,31,28,28,0
"DG_s09",135,388.141,388.766,389.813,389.813,26,14,10,10,12,82,1.047,1,26,14,12,0,-12
"DG_s09",136,390.813,391.438,392.344,392.344,18,2,10,10,16,82,0.906,1,18,2,16,0,-16
"DG_s09",137,393.344,393.969,395.219,395.219,16,16,10,10,0,76,1.25,1,16,16,0,0,0
"DG_s09",138,396.219,396.844,398.078,398.078,10,10,8,11,0,76,1.234,0,8,11,3,3,0
"DG_s09",139,399.094,399.719,400.734,400.734,10,10,10,26,0,76,1.015,0,10,26,16,16,0
"DG_s09",140,401.734,402.344,403.328,403.328,10,10,15,30,0,82,0.984,0,15,30,15,15,0
"DG_s09",141,404.328,404.938,405.953,405.953,22,10,10,10,12,76,1.015,1,22,10,12,0,-12
"DG_s09",142,406.953,407.563,408.656,408.656,12,4,10,10,8,76,1.093,1,12,4,8,0,-8
"DG_s09",143,409.656,410.266,411.234,411.25,26,14,10,10,12,82,0.968,1,26,14,12,0,-12
"DG_s09",144,412.25,412.875,413.516,413.531,22,6,10,10,16,76,0.641,1,22,6,16,0,-16
"DG_s09",145,414.531,415.141,416.203,416.203,10,10,6,22,0,82,1.062,0,6,22,16,16,0
"DG_s09",146,417.203,417.813,419.594,419.609,10,10,8,12,0,76,1.781,0,8,12,4,4,0
"DG_s09",147,420.609,421.219,422.375,422.375,10,10,3,12,0,82,1.156,0,3,12,9,9,0
"DG_s09",148,423.391,424.016,424.844,424.859,18,2,10,10,16,76,0.828,1,18,2,16,0,-16
"DG_s09",149,425.859,426.469,427.328,427.328,22,10,10,10,12,82,0.859,1,22,10,12,0,-12
"DG_s09",150,428.328,428.938,429.813,429.828,22,13,10,10,9,76,0.875,1,22,13,9,0,-9
"DG_s09",151,430.828,431.438,432.672,432.672,10,10,8,12,0,76,1.234,0,8,12,4,4,0
"DG_s09",152,433.672,434.297,435.5,435.516,10,10,3,12,0,76,1.203,0,3,12,9,9,0
"DG_s09",153,436.516,437.141,438.641,438.641,10,10,10,18,0,76,1.5,0,10,18,8,8,0
"DG_s09",154,439.641,440.266,441.781,441.781,12,12,10,10,0,76,1.515,1,12,12,0,0,0
"DG_s09",155,442.797,443.422,444.219,444.219,10,10,8,8,0,76,0.797,0,8,8,0,0,0
"DG_s09",156,445.219,445.844,447.313,447.313,28,4,10,10,24,76,1.469,1,28,4,24,0,-24
"DG_s09",157,448.313,448.938,449.906,449.922,22,6,10,10,16,82,0.968,1,22,6,16,0,-16
"DG_s09",158,450.922,451.547,452.313,452.313,30,15,10,10,15,76,0.766,1,30,15,15,0,-15
"DG_s09",159,453.313,453.938,454.625,454.625,28,4,10,10,24,76,0.687,1,28,4,24,0,-24
"DG_s09",160,455.625,456.25,457.313,457.313,10,10,4,4,0,76,1.063,0,4,4,0,0,0
"DG_s09",161,458.313,458.938,459.859,459.875,13,7,10,10,6,76,0.921,1,13,7,6,0,-6
"DG_s09",162,460.875,461.5,462.906,462.906,10,10,10,26,0,76,1.406,0,10,26,16,16,0
"DG_s09",163,463.906,464.516,465.766,465.766,10,10,13,22,0,76,1.25,0,13,22,9,9,0
"DG_s09",164,466.781,467.391,468.406,468.406,16,4,10,10,12,76,1.015,1,16,4,12,0,-12
"DG_s09",165,469.406,470.016,470.969,470.969,10,10,8,11,0,76,0.953,0,8,11,3,3,0
"DG_s09",166,471.969,472.594,473.5,473.5,18,18,10,10,0,76,0.906,1,18,18,0,0,0
"DG_s09",167,474.5,475.125,476.422,476.422,10,10,8,16,0,82,1.297,0,8,16,8,8,0
"DG_s09",168,477.438,478.063,479.938,479.938,10,10,3,17,0,76,1.875,0,3,17,14,14,0
"DG_s09",169,480.938,481.563,482.234,482.25,10,10,6,6,0,76,0.671,0,6,6,0,0,0
"DG_s09",170,483.25,483.875,485,485,14,26,10,10,12,82,1.125,1,14,26,12,12,0
"DG_s09",171,486,486.625,488,488,11,7,10,10,4,76,1.375,1,11,7,4,0,-4
"DG_s09",172,489,489.625,491.609,491.609,16,4,10,10,12,76,1.984,1,16,4,12,0,-12
"DG_s09",173,492.609,493.219,494.609,494.625,13,1,10,10,12,82,1.39,1,13,1,12,0,-12
"DG_s09",174,495.625,496.25,497.313,497.313,11,7,10,10,4,76,1.063,1,11,7,4,0,-4
"DG_s09",175,498.313,498.938,500.453,500.453,10,10,6,11,0,82,1.515,0,6,11,5,5,0
"DG_s09",176,501.469,502.094,503.078,503.078,10,10,15,30,0,82,0.984,0,15,30,15,15,0
"DG_s09",177,504.094,504.719,506.047,506.047,18,10,10,10,8,76,1.328,1,18,10,8,0,-8
"DG_s09",178,507.047,507.672,508.797,508.797,10,10,6,14,0,76,1.125,0,6,14,8,8,0
"DG_s09",179,509.813,510.438,511.578,511.578,10,10,10,22,0,76,1.14,0,10,22,12,12,0
"DG_s09",180,512.578,513.188,514.219,514.219,30,10,10,10,20,82,1.031,1,30,10,20,0,-20
"DG_s09",181,515.219,515.844,517.109,517.109,18,12,10,10,6,76,1.265,1,18,12,6,0,-6
"DG_s09",182,518.109,518.719,519.578,519.594,18,10,10,10,8,76,0.859,1,18,10,8,0,-8
"DG_s09",183,520.594,521.219,522.188,522.203,13,1,10,10,12,82,0.969,1,13,1,12,0,-12
"DG_s09",184,523.203,523.813,524.625,524.625,16,8,10,10,8,76,0.812,1,16,8,8,0,-8
"DG_s09",185,525.625,526.25,527.016,527.016,26,10,10,10,16,76,0.766,1,26,10,16,0,-16
"DG_s09",186,528.016,528.641,529.5,529.5,22,13,10,10,9,82,0.859,1,22,13,9,0,-9
"DG_s09",187,530.5,531.125,531.984,531.984,10,10,8,16,0,76,0.859,0,8,16,8,8,0
"DG_s09",188,532.984,533.594,535.125,535.125,10,10,12,18,0,82,1.531,0,12,18,6,6,0
"DG_s09",190,539.75,540.375,541.594,541.594,10,10,14,26,0,82,1.219,0,14,26,12,12,0
"DG_s09",191,542.594,543.219,544.234,544.25,10,10,10,30,0,76,1.015,0,10,30,20,20,0
"DG_s09",192,545.25,545.875,547.141,547.156,14,14,10,10,0,82,1.266,1,14,14,0,0,0
"DG_s09",193,548.156,548.766,549.703,549.703,10,10,6,14,0,76,0.937,0,6,14,8,8,0
"DG_s09",194,550.703,551.313,552.422,552.422,10,10,6,11,0,76,1.109,0,6,11,5,5,0
"DG_s09",195,553.438,554.063,554.813,554.813,30,15,10,10,15,76,0.75,1,30,15,15,0,-15
"DG_s09",196,555.813,556.438,557.188,557.188,10,10,3,17,0,76,0.75,0,3,17,14,14,0
"DG_s09",197,558.188,558.813,560.109,560.109,13,7,10,10,6,76,1.296,1,13,7,6,0,-6
"DG_s09",198,561.125,561.75,562.641,562.641,12,18,10,10,6,82,0.891,1,12,18,6,6,0
"DG_s09",199,563.641,564.266,565.469,565.469,16,8,10,10,8,76,1.203,1,16,8,8,0,-8
"DG_s09",200,566.484,567.094,568.234,568.25,10,10,10,30,0,76,1.14,0,10,30,20,20,0
"DG_s09",201,569.25,569.875,570.922,570.938,18,12,10,10,6,76,1.047,1,18,12,6,0,-6
"DG_s09",202,571.938,572.563,573.391,573.391,10,10,2,2,0,76,0.828,0,2,2,0,0,0
"DG_s09",203,574.391,575.016,576.906,576.922,10,10,3,31,0,76,1.89,0,3,31,28,28,0
"DG_s09",204,577.922,578.547,580.406,580.406,10,10,10,22,0,82,1.859,0,10,22,12,12,0
"DG_s09",205,581.422,582.047,583.609,583.625,26,10,10,10,16,82,1.562,1,26,10,16,0,-16
"DG_s09",206,584.625,585.25,586.141,586.156,30,10,10,10,20,76,0.891,1,30,10,20,0,-20
"DG_s09",207,587.156,587.766,589.344,589.344,10,10,6,22,0,82,1.578,0,6,22,16,16,0
"DG_s09",209,593.969,594.594,595.797,595.797,10,10,13,22,0,82,1.203,0,13,22,9,9,0
"DG_s09",210,596.813,597.438,598.672,598.672,10,10,3,31,0,76,1.234,0,3,31,28,28,0
"DG_s09",211,599.672,600.297,601.313,601.313,26,14,10,10,12,82,1.016,1,26,14,12,0,-12
"DG_s09",212,602.313,602.938,603.969,603.969,18,2,10,10,16,82,1.031,1,18,2,16,0,-16
"DG_s09",213,604.969,605.594,606.922,606.938,16,16,10,10,0,76,1.328,1,16,16,0,0,0
"DG_s09",214,607.938,608.563,610.375,610.375,10,10,8,11,0,76,1.812,0,8,11,3,3,0
"DG_s09",215,611.375,612,613.031,613.031,10,10,10,26,0,76,1.031,0,10,26,16,16,0
"DG_s09",216,614.031,614.641,616.047,616.047,10,10,15,30,0,82,1.406,0,15,30,15,15,0
"DG_s09",217,617.063,617.688,618.953,618.953,22,10,10,10,12,76,1.265,1,22,10,12,0,-12
"DG_s09",218,619.953,620.563,622.359,622.359,12,4,10,10,8,76,1.796,1,12,4,8,0,-8
"DG_s09",219,623.359,623.969,625.188,625.188,26,14,10,10,12,82,1.219,1,26,14,12,0,-12
"DG_s09",220,626.188,626.813,628.344,628.344,22,6,10,10,16,76,1.531,1,22,6,16,0,-16
"DG_s09",221,629.344,629.969,631.703,631.703,10,10,6,22,0,82,1.734,0,6,22,16,16,0
"DG_s09",222,632.703,633.313,634.813,634.813,10,10,8,12,0,76,1.5,0,8,12,4,4,0
"DG_s09",223,635.813,636.438,637.766,637.766,10,10,3,12,0,82,1.328,0,3,12,9,9,0
"DG_s09",225,642.391,643.016,643.609,643.625,22,10,10,10,12,82,0.593,1,22,10,12,0,-12
"DG_s09",226,644.625,645.25,645.797,645.797,22,13,10,10,9,76,0.547,1,22,13,9,0,-9
"DG_s09",227,646.797,647.422,648.109,648.109,10,10,8,12,0,76,0.687,0,8,12,4,4,0
"DG_s09",228,649.109,649.719,650.5,650.5,10,10,3,12,0,76,0.781,0,3,12,9,9,0
"DG_s10",1,-0.797,0,1.5,1.5,10,10,10,18,0,76,1.5,0,10,18,8,8,0
"DG_s10",2,2.5,3.297,4.437,4.437,12,12,10,10,0,76,1.14,1,12,12,0,0,0
"DG_s10",3,5.437,6.219,7.719,7.719,10,10,8,8,0,76,1.5,0,8,8,0,0,0
"DG_s10",4,8.719,9.515,10.297,10.297,28,4,10,10,24,76,0.782,1,28,4,24,0,-24
"DG_s10",5,11.297,12.094,12.906,12.906,22,6,10,10,16,82,0.812,1,22,6,16,0,-16
"DG_s10",6,13.906,14.703,15.953,15.969,30,15,10,10,15,76,1.25,1,30,15,15,0,-15
"DG_s10",7,16.969,17.765,19.125,19.125,28,4,10,10,24,76,1.36,1,28,4,24,0,-24
"DG_s10",8,20.125,20.922,22,22,10,10,4,4,0,76,1.078,0,4,4,0,0,0
"DG_s10",9,23,23.797,25.094,25.094,13,7,10,10,6,76,1.297,1,13,7,6,0,-6
"DG_s10",10,26.094,26.89,28.515,28.515,10,10,10,26,0,76,1.625,0,10,26,16,16,0
"DG_s10",11,29.515,30.297,31.437,31.437,13,22,10,10,9,82,1.14,1,13,22,9,9,0
"DG_s10",12,32.437,33.219,34.687,34.703,16,4,10,10,12,76,1.468,1,16,4,12,0,-12
"DG_s10",13,35.703,36.5,37.406,37.422,10,10,8,11,0,76,0.906,0,8,11,3,3,0
"DG_s10",14,38.422,39.219,40.828,40.828,18,18,10,10,0,76,1.609,1,18,18,0,0,0
"DG_s10",15,41.828,42.625,43.719,43.734,10,10,8,16,0,82,1.094,0,8,16,8,8,0
"DG_s10",16,44.734,45.531,46.437,46.453,10,10,3,17,0,76,0.906,0,3,17,14,14,0
"DG_s10",17,47.453,48.25,49.25,49.25,10,10,6,6,0,76,1,0,6,6,0,0,0
"DG_s10",18,50.25,51.047,52.656,52.672,10,10,14,26,0,76,1.609,0,14,26,12,12,0
"DG_s10",19,53.672,54.469,55.687,55.703,11,7,10,10,4,76,1.218,1,11,7,4,0,-4
"DG_s10",20,56.703,57.5,58.625,58.64,16,4,10,10,12,76,1.125,1,16,4,12,0,-12
"DG_s10",21,59.64,60.422,61.609,61.609,13,1,10,10,12,82,1.187,1,13,1,12,0,-12
"DG_s10",23,66.422,67.219,68.625,68.64,10,10,6,11,0,82,1.406,0,6,11,5,5,0
"DG_s10",25,73.422,74.219,75.312,75.328,18,10,10,10,8,76,1.093,1,18,10,8,0,-8
"DG_s10",26,76.328,77.125,78.062,78.062,10,10,6,14,0,76,0.937,0,6,14,8,8,0
"DG_s10",27,79.062,79.844,80.969,80.969,10,10,10,22,0,76,1.125,0,10,22,12,12,0
"DG_s10",28,81.969,82.765,84.062,84.062,30,10,10,10,20,82,1.297,1,30,10,20,0,-20
"DG_s10",29,85.062,85.844,87.453,87.453,18,12,10,10,6,76,1.609,1,18,12,6,0,-6
"DG_s10",30,88.453,89.25,90.562,90.562,18,10,10,10,8,76,1.312,1,18,10,8,0,-8
"DG_s10",31,91.562,92.344,93.75,93.765,13,1,10,10,12,82,1.406,1,13,1,12,0,-12
"DG_s10",32,94.765,95.547,97.344,97.359,16,8,10,10,8,76,1.797,1,16,8,8,0,-8
"DG_s10",33,98.359,99.156,100.109,100.125,26,10,10,10,16,76,0.953,1,26,10,16,0,-16
"DG_s10",34,101.125,101.922,102.953,102.953,22,13,10,10,9,82,1.031,1,22,13,9,0,-9
"DG_s10",35,103.953,104.75,105.562,105.562,10,10,8,16,0,76,0.812,0,8,16,8,8,0
"DG_s10",36,106.578,107.375,109.078,109.078,10,10,12,18,0,82,1.703,0,12,18,6,6,0
"DG_s10",37,110.078,110.875,111.844,111.844,10,10,12,4,0,82,0.969,0,12,4,8,0,-8
"DG_s10",38,112.844,113.64,115.375,115.39,10,10,14,26,0,82,1.735,0,14,26,12,12,0
"DG_s10",39,116.39,117.172,118.484,118.484,10,10,10,30,0,76,1.312,0,10,30,20,20,0
"DG_s10",40,119.484,120.281,121.687,121.687,14,14,10,10,0,82,1.406,1,14,14,0,0,0
"DG_s10",41,122.687,123.469,124.25,124.25,10,10,6,14,0,76,0.781,0,6,14,8,8,0
"DG_s10",42,125.25,126.047,127.078,127.094,10,10,6,11,0,76,1.031,0,6,11,5,5,0
"DG_s10",43,128.094,128.89,130.047,130.062,30,15,10,10,15,76,1.157,1,30,15,15,0,-15
"DG_s10",44,131.062,131.844,132.672,132.672,10,10,3,17,0,76,0.828,0,3,17,14,14,0
"DG_s10",45,133.672,134.469,135.875,135.875,10,10,13,7,0,82,1.406,0,13,7,6,0,-6
"DG_s10",46,136.875,137.672,139.281,139.281,10,10,12,18,0,76,1.609,0,12,18,6,6,0
"DG_s10",47,140.297,141.094,142.515,142.515,16,8,10,10,8,76,1.421,1,16,8,8,0,-8
"DG_s10",48,143.515,144.297,145.547,145.547,10,10,10,30,0,76,1.25,0,10,30,20,20,0
"DG_s10",49,146.547,147.344,148.625,148.625,18,12,10,10,6,76,1.281,1,18,12,6,0,-6
"DG_s10",50,149.64,150.422,151.187,151.187,10,10,2,2,0,76,0.765,0,2,2,0,0,0
"DG_s10",51,152.187,152.969,153.734,153.734,10,10,3,31,0,76,0.765,0,3,31,28,28,0
"DG_s10",52,154.734,155.531,156.875,156.875,10,10,10,22,0,82,1.344,0,10,22,12,12,0
"DG_s10",53,157.875,158.672,160.156,160.156,26,10,10,10,16,82,1.484,1,26,10,16,0,-16
"DG_s10",54,161.156,161.953,162.875,162.875,30,10,10,10,20,76,0.922,1,30,10,20,0,-20
"DG_s10",55,163.875,164.672,165.984,166,10,10,6,22,0,82,1.312,0,6,22,16,16,0
"DG_s10",56,167,167.797,169.328,169.328,10,10,10,18,0,76,1.531,0,10,18,8,8,0
"DG_s10",57,170.328,171.125,171.969,171.969,13,22,10,10,9,76,0.844,1,13,22,9,9,0
"DG_s10",58,172.969,173.765,174.5,174.5,10,10,3,31,0,76,0.735,0,3,31,28,28,0
"DG_s10",59,175.5,176.297,177.281,177.281,26,14,10,10,12,82,0.984,1,26,14,12,0,-12
"DG_s10",60,178.281,179.078,180.859,180.859,18,2,10,10,16,82,1.781,1,18,2,16,0,-16
"DG_s10",61,181.859,182.656,184.297,184.297,16,16,10,10,0,76,1.641,1,16,16,0,0,0
"DG_s10",62,185.312,186.094,186.953,186.953,10,10,8,11,0,76,0.859,0,8,11,3,3,0
"DG_s10",63,187.969,188.765,190.062,190.078,10,10,10,26,0,76,1.297,0,10,26,16,16,0
"DG_s10",64,191.078,191.875,193.5,193.5,10,10,15,30,0,82,1.625,0,15,30,15,15,0
"DG_s10",65,194.5,195.297,195.953,195.953,22,10,10,10,12,76,0.656,1,22,10,12,0,-12
"DG_s10",66,196.969,197.765,199.344,199.359,12,4,10,10,8,76,1.579,1,12,4,8,0,-8
"DG_s10",67,200.359,201.156,202.062,202.078,26,14,10,10,12,82,0.906,1,26,14,12,0,-12
"DG_s10",68,203.078,203.875,204.672,204.672,22,6,10,10,16,76,0.797,1,22,6,16,0,-16
"DG_s10",69,205.672,206.469,207.547,207.547,10,10,6,22,0,82,1.078,0,6,22,16,16,0
"DG_s10",70,208.547,209.344,210.031,210.047,10,10,8,12,0,76,0.687,0,8,12,4,4,0
"DG_s10",71,211.047,211.844,212.531,212.531,10,10,3,12,0,82,0.687,0,3,12,9,9,0
"DG_s10",72,213.531,214.328,214.875,214.875,18,2,10,10,16,76,0.547,1,18,2,16,0,-16
"DG_s10",73,215.875,216.672,217.656,217.656,22,10,10,10,12,82,0.984,1,22,10,12,0,-12
"DG_s10",74,218.656,219.453,220.765,220.765,22,13,10,10,9,76,1.312,1,22,13,9,0,-9
"DG_s10",75,221.765,222.547,223.453,223.453,10,10,8,12,0,76,0.906,0,8,12,4,4,0
"DG_s10",76,224.453,225.25,226.344,226.359,10,10,3,12,0,76,1.094,0,3,12,9,9,0
"DG_s10",77,227.359,228.156,229.953,229.953,10,10,10,18,0,76,1.797,0,10,18,8,8,0
"DG_s10",78,230.969,231.765,233.125,233.14,12,12,10,10,0,76,1.36,1,12,12,0,0,0
"DG_s10",79,234.14,234.922,235.922,235.922,10,10,8,8,0,76,1,0,8,8,0,0,0
"DG_s10",80,236.922,237.719,238.594,238.594,28,4,10,10,24,76,0.875,1,28,4,24,0,-24
"DG_s10",81,239.594,240.39,241.219,241.219,22,6,10,10,16,82,0.829,1,22,6,16,0,-16
"DG_s10",82,242.219,243.015,244.453,244.453,30,15,10,10,15,76,1.438,1,30,15,15,0,-15
"DG_s10",83,245.453,246.25,247.265,247.265,28,4,10,10,24,76,1.015,1,28,4,24,0,-24
"DG_s10",84,248.281,249.078,249.844,249.844,10,10,4,4,0,76,0.766,0,4,4,0,0,0
"DG_s10",85,250.844,251.64,252.781,252.781,13,7,10,10,6,76,1.141,1,13,7,6,0,-6
"DG_s10",86,253.781,254.578,255.875,255.875,10,10,10,26,0,76,1.297,0,10,26,16,16,0
"DG_s10",87,256.875,257.672,259.625,259.625,10,10,13,22,0,76,1.953,0,13,22,9,9,0
"DG_s10",88,260.625,261.422,262.484,262.484,16,4,10,10,12,76,1.062,1,16,4,12,0,-12
"DG_s10",89,263.484,264.281,265.062,265.078,10,10,8,11,0,76,0.781,0,8,11,3,3,0
"DG_s10",90,266.078,266.875,268.234,268.234,18,18,10,10,0,76,1.359,1,18,18,0,0,0
"DG_s10",92,273.031,273.828,274.812,274.812,10,10,3,17,0,76,0.984,0,3,17,14,14,0
"DG_s10",93,275.812,276.594,277.312,277.312,10,10,6,6,0,76,0.718,0,6,6,0,0,0
"DG_s10",94,278.312,279.094,279.781,279.781,14,26,10,10,12,82,0.687,1,14,26,12,12,0
"DG_s10",95,280.781,281.578,282.812,282.812,11,7,10,10,4,76,1.234,1,11,7,4,0,-4
"DG_s10",96,283.812,284.594,285.922,285.922,10,10,16,4,0,82,1.328,0,16,4,12,0,-12
"DG_s10",97,286.937,287.719,288.406,288.422,10,10,13,1,0,76,0.687,0,13,1,12,0,-12
"DG_s10",98,289.422,290.219,291.609,291.609,11,7,10,10,4,76,1.39,1,11,7,4,0,-4
"DG_s10",99,292.625,293.422,294.687,294.687,10,10,6,11,0,82,1.265,0,6,11,5,5,0
"DG_s10",100,295.687,296.469,298.125,298.14,10,10,15,30,0,82,1.656,0,15,30,15,15,0
"DG_s10",101,299.14,299.922,300.89,300.89,18,10,10,10,8,76,0.968,1,18,10,8,0,-8
"DG_s10",102,301.89,302.672,303.375,303.375,10,10,6,14,0,76,0.703,0,6,14,8,8,0
"DG_s10",104,308.172,308.969,310.547,310.547,30,10,10,10,20,82,1.578,1,30,10,20,0,-20
"DG_s10",105,311.547,312.344,313.453,313.453,18,12,10,10,6,76,1.109,1,18,12,6,0,-6
"DG_s10",106,314.453,315.25,316.797,316.797,18,10,10,10,8,76,1.547,1,18,10,8,0,-8
"DG_s10",107,317.797,318.594,319.39,319.406,13,1,10,10,12,82,0.796,1,13,1,12,0,-12
"DG_s10",108,320.406,321.203,322.172,322.172,16,8,10,10,8,76,0.969,1,16,8,8,0,-8
"DG_s10",109,323.172,323.969,324.765,324.765,26,10,10,10,16,76,0.796,1,26,10,16,0,-16
"DG_s10",110,325.765,326.547,327.14,327.14,22,13,10,10,9,82,0.593,1,22,13,9,0,-9
"DG_s10",111,328.14,328.922,329.937,329.937,10,10,8,16,0,76,1.015,0,8,16,8,8,0
"DG_s10",112,330.953,331.75,333.234,333.234,10,10,12,18,0,82,1.484,0,12,18,6,6,0
"DG_s10",113,334.234,335.031,336.375,336.39,10,10,12,4,0,82,1.344,0,12,4,8,0,-8
"DG_s10",114,337.39,338.172,339.719,339.734,10,10,14,26,0,82,1.547,0,14,26,12,12,0
"DG_s10",115,340.734,341.531,342.812,342.828,10,10,10,30,0,76,1.281,0,10,30,20,20,0
"DG_s10",116,343.828,344.625,346.015,346.015,14,14,10,10,0,82,1.39,1,14,14,0,0,0
"DG_s10",117,347.015,347.797,348.719,348.719,10,10,6,14,0,76,0.922,0,6,14,8,8,0
"DG_s10",118,349.719,350.515,351.39,351.406,10,10,6,11,0,76,0.875,0,6,11,5,5,0
"DG_s10",119,352.406,353.203,354.125,354.125,30,15,10,10,15,76,0.922,1,30,15,15,0,-15
"DG_s10",120,355.125,355.922,356.797,356.797,10,10,3,17,0,76,0.875,0,3,17,14,14,0
"DG_s10",121,357.797,358.594,360.094,360.109,13,7,10,10,6,76,1.5,1,13,7,6,0,-6
"DG_s10",122,361.109,361.906,362.859,362.859,12,18,10,10,6,82,0.953,1,12,18,6,6,0
"DG_s10",123,363.859,364.656,366.375,366.375,16,8,10,10,8,76,1.719,1,16,8,8,0,-8
"DG_s10",124,367.375,368.172,369.406,369.422,10,10,10,30,0,76,1.234,0,10,30,20,20,0
"DG_s10",125,370.422,371.219,372.609,372.609,18,12,10,10,6,76,1.39,1,18,12,6,0,-6
"DG_s10",126,373.609,374.406,375.344,375.344,10,10,2,2,0,76,0.938,0,2,2,0,0,0
"DG_s10",127,376.344,377.14,378.094,378.094,10,10,3,31,0,76,0.954,0,3,31,28,28,0
"DG_s10",128,379.094,379.89,381.422,381.422,10,10,10,22,0,82,1.532,0,10,22,12,12,0
"DG_s10",129,382.422,383.219,384.297,384.297,26,10,10,10,16,82,1.078,1,26,10,16,0,-16
"DG_s10",130,385.297,386.094,387.234,387.234,30,10,10,10,20,76,1.14,1,30,10,20,0,-20
"DG_s10",131,388.234,389.031,390.594,390.594,10,10,6,22,0,82,1.563,0,6,22,16,16,0
"DG_s10",132,391.594,392.39,393.234,393.234,10,10,10,18,0,76,0.844,0,10,18,8,8,0
"DG_s10",133,394.234,395.031,396.328,396.328,10,10,13,22,0,82,1.297,0,13,22,9,9,0
"DG_s10",134,397.328,398.125,398.922,398.922,10,10,3,31,0,76,0.797,0,3,31,28,28,0
"DG_s10",135,399.922,400.719,401.687,401.687,26,14,10,10,12,82,0.968,1,26,14,12,0,-12
"DG_s10",136,402.687,403.469,404.469,404.484,18,2,10,10,16,82,1,1,18,2,16,0,-16
"DG_s10",137,405.484,406.281,407.156,407.172,16,16,10,10,0,76,0.875,1,16,16,0,0,0
"DG_s10",138,408.172,408.969,410.203,410.203,10,10,8,11,0,76,1.234,0,8,11,3,3,0
"DG_s10",140,415,415.797,417.609,417.609,10,10,15,30,0,82,1.812,0,15,30,15,15,0
"DG_s10",141,418.609,419.406,420.39,420.406,22,10,10,10,12,76,0.984,1,22,10,12,0,-12
"DG_s10",142,421.406,422.203,423.203,423.203,10,10,12,4,0,82,1,0,12,4,8,0,-8
"DG_s10",143,424.203,425,425.812,425.828,26,14,10,10,12,82,0.812,1,26,14,12,0,-12
"DG_s10",144,426.828,427.625,428.328,428.328,22,6,10,10,16,76,0.703,1,22,6,16,0,-16
"DG_s10",145,429.328,430.125,431.125,431.14,10,10,6,22,0,82,1,0,6,22,16,16,0
"DG_s10",146,432.14,432.922,433.922,433.922,10,10,8,12,0,76,1,0,8,12,4,4,0
"DG_s10",147,434.922,435.719,437.203,437.203,10,10,3,12,0,82,1.484,0,3,12,9,9,0
"DG_s10",148,438.203,439,440.375,440.375,18,2,10,10,16,76,1.375,1,18,2,16,0,-16
"DG_s10",149,441.375,442.172,442.953,442.953,22,10,10,10,12,82,0.781,1,22,10,12,0,-12
"DG_s10",150,443.953,444.75,445.937,445.937,22,13,10,10,9,76,1.187,1,22,13,9,0,-9
"DG_s10",151,446.937,447.719,448.906,448.906,10,10,8,12,0,76,1.187,0,8,12,4,4,0
"DG_s10",152,449.906,450.703,451.281,451.281,10,10,3,12,0,76,0.578,0,3,12,9,9,0
"DG_s10",153,452.281,453.078,453.703,453.703,10,10,10,18,0,76,0.625,0,10,18,8,8,0
"DG_s10",154,454.719,455.515,456.703,456.703,10,10,12,12,0,82,1.188,0,12,12,0,0,0
"DG_s10",155,457.703,458.5,459.781,459.781,10,10,8,8,0,76,1.281,0,8,8,0,0,0
"DG_s10",156,460.781,461.578,462.515,462.531,28,4,10,10,24,76,0.937,1,28,4,24,0,-24
"DG_s10",157,463.531,464.328,465.328,465.328,22,6,10,10,16,82,1,1,22,6,16,0,-16
"DG_s10",158,466.328,467.125,468.703,468.719,30,15,10,10,15,76,1.578,1,30,15,15,0,-15
"DG_s10",159,469.719,470.515,471.172,471.187,28,4,10,10,24,76,0.657,1,28,4,24,0,-24
"DG_s10",160,472.187,472.969,473.609,473.609,10,10,4,4,0,76,0.64,0,4,4,0,0,0
"DG_s10",161,474.609,475.406,476.89,476.89,13,7,10,10,6,76,1.484,1,13,7,6,0,-6
"DG_s10",162,477.89,478.672,479.984,479.984,10,10,10,26,0,76,1.312,0,10,26,16,16,0
"DG_s10",163,481,481.797,483.5,483.5,10,10,13,22,0,76,1.703,0,13,22,9,9,0
"DG_s10",164,484.5,485.297,486.265,486.265,16,4,10,10,12,76,0.968,1,16,4,12,0,-12
"DG_s10",165,487.265,488.047,488.828,488.844,10,10,8,11,0,76,0.781,0,8,11,3,3,0
"DG_s10",166,489.844,490.64,492.5,492.5,18,18,10,10,0,76,1.86,1,18,18,0,0,0
"DG_s10",167,493.5,494.297,495.203,495.203,10,10,8,16,0,82,0.906,0,8,16,8,8,0
"DG_s10",168,496.203,497,497.969,497.969,10,10,3,17,0,76,0.969,0,3,17,14,14,0
"DG_s10",169,498.969,499.765,501.281,501.281,10,10,6,6,0,76,1.516,0,6,6,0,0,0
"DG_s10",170,502.281,503.078,504.672,504.672,10,10,14,26,0,76,1.594,0,14,26,12,12,0
"DG_s10",171,505.672,506.469,507.937,507.937,11,7,10,10,4,76,1.468,1,11,7,4,0,-4
"DG_s10",172,508.937,509.719,510.969,510.969,16,4,10,10,12,76,1.25,1,16,4,12,0,-12
"DG_s10",173,511.984,512.781,513.5,513.515,13,1,10,10,12,82,0.719,1,13,1,12,0,-12
"DG_s10",174,514.515,515.297,516.437,516.453,11,7,10,10,4,76,1.14,1,11,7,4,0,-4
"DG_s10",175,517.453,518.25,519.187,519.203,10,10,6,11,0,82,0.937,0,6,11,5,5,0
"DG_s10",176,520.203,521,522.765,522.765,10,10,15,30,0,82,1.765,0,15,30,15,15,0
"DG_s10",177,523.765,524.547,525.703,525.703,18,10,10,10,8,76,1.156,1,18,10,8,0,-8
"DG_s10",178,526.703,527.5,528.312,528.312,10,10,6,14,0,76,0.812,0,6,14,8,8,0
"DG_s10",179,529.312,530.094,531.234,531.234,10,10,10,22,0,76,1.14,0,10,22,12,12,0
"DG_s10",180,532.234,533.031,534.203,534.219,30,10,10,10,20,82,1.172,1,30,10,20,0,-20
"DG_s10",182,539.015,539.797,540.812,540.812,18,10,10,10,8,76,1.015,1,18,10,8,0,-8
"DG_s10",183,541.812,542.594,543.578,543.578,13,1,10,10,12,82,0.984,1,13,1,12,0,-12
"DG_s10",184,544.578,545.375,546.453,546.469,16,8,10,10,8,76,1.078,1,16,8,8,0,-8
"DG_s10",185,547.469,548.265,549.078,549.094,26,10,10,10,16,76,0.813,1,26,10,16,0,-16
"DG_s10",187,553.89,554.672,555.328,555.328,10,10,8,16,0,76,0.656,0,8,16,8,8,0
"DG_s10",188,556.328,557.125,558.234,558.234,12,18,10,10,6,76,1.109,1,12,18,6,6,0
"DG_s10",189,559.234,560.031,560.937,560.937,10,10,12,4,0,82,0.906,0,12,4,8,0,-8
"DG_s10",190,561.937,562.719,564.25,564.25,10,10,14,26,0,82,1.531,0,14,26,12,12,0
"DG_s10",191,565.25,566.047,567.312,567.312,10,10,10,30,0,76,1.265,0,10,30,20,20,0
"DG_s10",192,568.328,569.125,569.875,569.89,14,14,10,10,0,82,0.75,1,14,14,0,0,0
"DG_s10",193,570.89,571.672,572.437,572.453,10,10,6,14,0,76,0.765,0,6,14,8,8,0
"DG_s10",194,573.453,574.25,575.156,575.172,10,10,6,11,0,76,0.906,0,6,11,5,5,0
"DG_s10",195,576.172,576.969,577.672,577.672,30,15,10,10,15,76,0.703,1,30,15,15,0,-15
"DG_s10",196,578.672,579.469,580.781,580.797,10,10,3,17,0,76,1.312,0,3,17,14,14,0
"DG_s10",197,581.797,582.594,583.781,583.781,13,7,10,10,6,76,1.187,1,13,7,6,0,-6
"DG_s10",198,584.781,585.578,586.672,586.672,12,18,10,10,6,82,1.094,1,12,18,6,6,0
"DG_s10",199,587.672,588.469,589.094,589.094,16,8,10,10,8,76,0.625,1,16,8,8,0,-8
"DG_s10",200,590.094,590.89,592.312,592.312,10,10,10,30,0,76,1.422,0,10,30,20,20,0
"DG_s10",202,597.094,597.89,598.609,598.609,10,10,2,2,0,76,0.719,0,2,2,0,0,0
"DG_s10",203,599.609,600.406,601.594,601.594,10,10,3,31,0,76,1.188,0,3,31,28,28,0
"DG_s10",204,602.594,603.39,604.765,604.781,10,10,10,22,0,82,1.375,0,10,22,12,12,0
"DG_s10",205,605.781,606.578,607.422,607.422,26,10,10,10,16,82,0.844,1,26,10,16,0,-16
"DG_s10",206,608.422,609.219,609.781,609.797,30,10,10,10,20,76,0.562,1,30,10,20,0,-20
"DG_s10",207,610.797,611.594,612.594,612.594,10,10,6,22,0,82,1,0,6,22,16,16,0
"DG_s10",209,617.39,618.172,619.969,619.969,10,10,13,22,0,82,1.797,0,13,22,9,9,0
"DG_s10",210,620.969,621.765,622.484,622.5,10,10,3,31,0,76,0.719,0,3,31,28,28,0
"DG_s10",211,623.5,624.297,625.594,625.594,26,14,10,10,12,82,1.297,1,26,14,12,0,-12
"DG_s10",212,626.594,627.39,628.922,628.922,18,2,10,10,16,82,1.532,1,18,2,16,0,-16
"DG_s10",213,629.922,630.719,631.937,631.937,16,16,10,10,0,76,1.218,1,16,16,0,0,0
"DG_s10",215,636.719,637.515,638.687,638.687,10,10,10,26,0,76,1.172,0,10,26,16,16,0
"DG_s10",216,639.703,640.5,641.859,641.859,10,10,15,30,0,82,1.359,0,15,30,15,15,0
"DG_s10",217,642.859,643.656,644.89,644.906,22,10,10,10,12,76,1.234,1,22,10,12,0,-12
"DG_s10",218,645.906,646.703,647.89,647.906,10,10,12,4,0,82,1.187,0,12,4,8,0,-8
"DG_s10",219,648.906,649.703,650.281,650.281,10,10,26,14,0,76,0.578,0,26,14,12,0,-12
"DG_s10",220,651.281,652.078,652.703,652.703,22,6,10,10,16,76,0.625,1,22,6,16,0,-16
"DG_s10",221,653.719,654.515,655.531,655.531,10,10,6,22,0,82,1.016,0,6,22,16,16,0
"DG_s10",222,656.531,657.328,658.015,658.015,10,10,8,12,0,76,0.687,0,8,12,4,4,0
"DG_s10",223,659.031,659.828,660.609,660.609,10,10,3,12,0,82,0.781,0,3,12,9,9,0
"DG_s10",224,661.609,662.406,663,663,18,2,10,10,16,76,0.594,1,18,2,16,0,-16
"DG_s10",225,664,664.797,665.875,665.875,22,10,10,10,12,82,1.078,1,22,10,12,0,-12
"DG_s10",226,666.875,667.672,668.328,668.328,22,13,10,10,9,76,0.656,1,22,13,9,0,-9
"DG_s10",227,669.328,670.125,670.906,670.906,10,10,8,12,0,76,0.781,0,8,12,4,4,0
"DG_s10",228,671.906,672.703,673.359,673.359,10,10,3,12,0,76,0.656,0,3,12,9,9,0
"DG_s11",1,-0.61,0,2.015,2.031,10,10,10,18,0,76,2.015,0,10,18,8,8,0
"DG_s11",2,3.031,3.64,4.797,4.812,12,12,10,10,0,76,1.157,1,12,12,0,0,0
"DG_s11",3,5.812,6.422,7.89,7.89,10,10,8,8,0,76,1.468,0,8,8,0,0,0
"DG_s11",4,8.89,9.5,10.922,10.922,10,10,28,4,0,82,1.422,0,28,4,24,0,-24
"DG_s11",5,11.922,12.531,13.968,13.968,10,10,22,6,0,76,1.437,0,22,6,16,0,-16
"DG_s11",6,14.984,15.593,16.828,16.843,10,10,30,15,0,82,1.235,0,30,15,15,0,-15
"DG_s11",7,17.843,18.453,19.593,19.593,10,10,28,4,0,82,1.14,0,28,4,24,0,-24
"DG_s11",8,20.593,21.203,22.312,22.312,10,10,4,4,0,76,1.109,0,4,4,0,0,0
"DG_s11",9,23.328,23.937,25.031,25.047,10,10,13,7,0,82,1.094,0,13,7,6,0,-6
"DG_s11",10,26.047,26.656,27.703,27.718,10,10,10,26,0,76,1.047,0,10,26,16,16,0
"DG_s11",11,28.718,29.328,30.156,30.172,10,10,13,22,0,76,0.828,0,13,22,9,9,0
"DG_s11",12,31.172,31.781,33.125,33.14,10,10,16,4,0,82,1.344,0,16,4,12,0,-12
"DG_s11",13,34.14,34.75,35.468,35.484,10,10,8,11,0,76,0.718,0,8,11,3,3,0
"DG_s11",14,36.484,37.093,37.922,37.922,18,18,10,10,0,76,0.829,1,18,18,0,0,0
"DG_s11",15,38.922,39.531,40.687,40.687,10,10,8,16,0,82,1.156,0,8,16,8,8,0
"DG_s11",16,41.687,42.297,43,43,10,10,3,17,0,76,0.703,0,3,17,14,14,0
"DG_s11",17,44,44.609,45.422,45.422,10,10,6,6,0,76,0.813,0,6,6,0,0,0
"DG_s11",18,46.422,47.031,47.843,47.843,10,10,14,26,0,76,0.812,0,14,26,12,12,0
"DG_s11",19,48.843,49.453,50.562,50.562,10,10,11,7,0,82,1.109,0,11,7,4,0,-4
"DG_s11",20,51.562,52.172,53.25,53.25,10,10,16,4,0,82,1.078,0,16,4,12,0,-12
"DG_s11",21,54.25,54.859,55.578,55.578,10,10,13,1,0,76,0.719,0,13,1,12,0,-12
"DG_s11",22,56.578,57.187,58.25,58.25,10,10,11,7,0,82,1.063,0,11,7,4,0,-4
"DG_s11",23,59.25,59.859,61.843,61.843,10,10,6,11,0,82,1.984,0,6,11,5,5,0
"DG_s11",24,62.843,63.453,64.656,64.656,10,10,15,30,0,82,1.203,0,15,30,15,15,0
"DG_s11",25,65.656,66.265,67.39,67.39,10,10,18,10,0,82,1.125,0,18,10,8,0,-8
"DG_s11",26,68.39,69,69.968,69.968,10,10,6,14,0,76,0.968,0,6,14,8,8,0
"DG_s11",27,70.984,71.593,72.5,72.515,10,10,10,22,0,76,0.907,0,10,22,12,12,0
"DG_s11",28,73.515,74.125,74.953,74.953,10,10,30,10,0,76,0.828,0,30,10,20,0,-20
"DG_s11",29,75.953,76.562,78,78,10,10,18,12,0,82,1.438,0,18,12,6,0,-6
"DG_s11",30,79.015,79.625,81.109,81.125,10,10,18,10,0,82,1.484,0,18,10,8,0,-8
"DG_s11",31,82.125,82.734,83.422,83.437,10,10,13,1,0,76,0.688,0,13,1,12,0,-12
"DG_s11",32,84.437,85.047,86.5,86.5,10,10,16,8,0,82,1.453,0,16,8,8,0,-8
"DG_s11",33,87.5,88.109,89.25,89.25,10,10,26,10,0,82,1.141,0,26,10,16,0,-16
"DG_s11",34,90.25,90.859,91.593,91.593,10,10,22,13,0,76,0.734,0,22,13,9,0,-9
"DG_s11",35,92.593,93.203,93.953,93.953,10,10,8,16,0,76,0.75,0,8,16,8,8,0
"DG_s11",36,94.968,95.578,96.812,96.812,10,10,12,18,0,82,1.234,0,12,18,6,6,0
"DG_s11",37,97.812,98.422,99.906,99.906,10,10,12,4,0,82,1.484,0,12,4,8,0,-8
"DG_s11",38,100.906,101.515,102.843,102.843,10,10,14,26,0,82,1.328,0,14,26,12,12,0
"DG_s11",39,103.843,104.453,105.406,105.406,10,10,10,30,0,76,0.953,0,10,30,20,20,0
"DG_s11",40,106.406,107.015,108.328,108.328,10,10,14,14,0,76,1.313,0,14,14,0,0,0
"DG_s11",41,109.328,109.937,111.062,111.078,10,10,6,14,0,76,1.125,0,6,14,8,8,0
"DG_s11",42,112.078,112.687,113.89,113.89,10,10,6,11,0,76,1.203,0,6,11,5,5,0
"DG_s11",43,114.89,115.5,116.984,116.984,30,15,10,10,15,76,1.484,1,30,15,15,0,-15
"DG_s11",44,117.984,118.593,119.625,119.625,10,10,3,17,0,76,1.032,0,3,17,14,14,0
"DG_s11",45,120.625,121.234,122.531,122.547,10,10,13,7,0,82,1.297,0,13,7,6,0,-6
"DG_s11",46,123.547,124.156,125.093,125.109,10,10,12,18,0,76,0.937,0,12,18,6,6,0
"DG_s11",47,126.109,126.718,127.797,127.797,16,8,10,10,8,76,1.079,1,16,8,8,0,-8
"DG_s11",48,128.797,129.406,130.328,130.328,10,10,10,30,0,76,0.922,0,10,30,20,20,0
"DG_s11",49,131.328,131.937,133.14,133.14,18,12,10,10,6,76,1.203,1,18,12,6,0,-6
"DG_s11",50,134.14,134.75,136.39,136.406,10,10,2,2,0,76,1.64,0,2,2,0,0,0
"DG_s11",51,137.406,138.015,139.437,139.437,10,10,3,31,0,76,1.422,0,3,31,28,28,0
"DG_s11",52,140.437,141.047,142.343,142.343,10,10,10,22,0,82,1.296,0,10,22,12,12,0
"DG_s11",53,143.343,143.953,144.828,144.843,10,10,26,10,0,76,0.875,0,26,10,16,0,-16
"DG_s11",54,145.843,146.453,147.5,147.515,30,10,10,10,20,76,1.047,1,30,10,20,0,-20
"DG_s11",55,148.515,149.125,150.375,150.375,10,10,6,22,0,82,1.25,0,6,22,16,16,0
"DG_s11",56,151.375,151.984,152.906,152.906,10,10,10,18,0,76,0.922,0,10,18,8,8,0
"DG_s11",57,153.906,154.515,155.812,155.812,10,10,13,22,0,82,1.297,0,13,22,9,9,0
"DG_s11",58,156.812,157.422,158.672,158.672,10,10,3,31,0,76,1.25,0,3,31,28,28,0
"DG_s11",59,159.687,160.297,161.672,161.672,26,14,10,10,12,82,1.375,1,26,14,12,0,-12
"DG_s11",60,162.687,163.297,164.515,164.515,18,2,10,10,16,82,1.218,1,18,2,16,0,-16
"DG_s11",61,165.515,166.125,167.359,167.359,10,10,16,16,0,82,1.234,0,16,16,0,0,0
"DG_s11",62,168.375,168.984,169.953,169.953,10,10,8,11,0,76,0.969,0,8,11,3,3,0
"DG_s11",63,170.953,171.562,172.437,172.437,10,10,10,26,0,76,0.875,0,10,26,16,16,0
"DG_s11",64,173.437,174.047,175.484,175.5,10,10,15,30,0,82,1.437,0,15,30,15,15,0
"DG_s11",65,176.5,177.109,178.031,178.031,22,10,10,10,12,76,0.922,1,22,10,12,0,-12
"DG_s11",66,179.047,179.656,180.922,180.922,12,4,10,10,8,76,1.266,1,12,4,8,0,-8
"DG_s11",67,181.922,182.531,183.781,183.781,26,14,10,10,12,82,1.25,1,26,14,12,0,-12
"DG_s11",68,184.781,185.39,186.437,186.453,22,6,10,10,16,76,1.047,1,22,6,16,0,-16
"DG_s11",69,187.453,188.062,189.14,189.156,10,10,6,22,0,82,1.078,0,6,22,16,16,0
"DG_s11",70,190.156,190.765,192.015,192.015,10,10,8,12,0,76,1.25,0,8,12,4,4,0
"DG_s11",71,193.015,193.625,194.734,194.734,10,10,3,12,0,82,1.109,0,3,12,9,9,0
"DG_s11",72,195.734,196.343,197.484,197.484,18,2,10,10,16,76,1.141,1,18,2,16,0,-16
"DG_s11",73,198.484,199.093,200.203,200.218,22,10,10,10,12,82,1.11,1,22,10,12,0,-12
"DG_s11",74,201.218,201.828,202.922,202.922,22,13,10,10,9,76,1.094,1,22,13,9,0,-9
"DG_s11",75,203.922,204.531,205.718,205.718,10,10,8,12,0,76,1.187,0,8,12,4,4,0
"DG_s11",76,206.734,207.343,208.265,208.265,10,10,3,12,0,76,0.922,0,3,12,9,9,0
"DG_s11",77,209.265,209.875,210.797,210.812,10,10,10,18,0,76,0.922,0,10,18,8,8,0
"DG_s11",78,211.812,212.422,213.578,213.578,12,12,10,10,0,76,1.156,1,12,12,0,0,0
"DG_s11",79,214.578,215.187,216.234,216.234,10,10,8,8,0,76,1.047,0,8,8,0,0,0
"DG_s11",80,217.234,217.843,218.812,218.812,28,4,10,10,24,76,0.969,1,28,4,24,0,-24
"DG_s11",81,219.812,220.422,221.984,221.984,22,6,10,10,16,82,1.562,1,22,6,16,0,-16
"DG_s11",82,223,223.609,224.703,224.703,30,15,10,10,15,76,1.094,1,30,15,15,0,-15
"DG_s11",83,225.718,226.328,227.218,227.218,28,4,10,10,24,76,0.89,1,28,4,24,0,-24
"DG_s11",84,228.218,228.828,230.078,230.078,10,10,4,4,0,76,1.25,0,4,4,0,0,0
"DG_s11",85,231.078,231.687,232.734,232.75,13,7,10,10,6,76,1.047,1,13,7,6,0,-6
"DG_s11",86,233.75,234.359,235.765,235.781,10,10,10,26,0,76,1.406,0,10,26,16,16,0
"DG_s11",87,236.781,237.39,238.734,238.734,10,10,13,22,0,76,1.344,0,13,22,9,9,0
"DG_s11",88,239.734,240.343,241.406,241.422,16,4,10,10,12,76,1.063,1,16,4,12,0,-12
"DG_s11",89,242.422,243.031,244.078,244.078,10,10,8,11,0,76,1.047,0,8,11,3,3,0
"DG_s11",90,245.078,245.687,246.797,246.797,18,18,10,10,0,76,1.11,1,18,18,0,0,0
"DG_s11",91,247.797,248.406,249.578,249.578,10,10,8,16,0,82,1.172,0,8,16,8,8,0
"DG_s11",92,250.578,251.187,252.437,252.453,10,10,3,17,0,76,1.25,0,3,17,14,14,0
"DG_s11",93,253.453,254.062,255.375,255.375,10,10,6,6,0,76,1.313,0,6,6,0,0,0
"DG_s11",94,256.375,256.984,257.984,257.984,10,10,14,26,0,76,1,0,14,26,12,12,0
"DG_s11",95,258.984,259.593,260.859,260.875,11,7,10,10,4,76,1.266,1,11,7,4,0,-4
"DG_s11",96,261.875,262.484,263.515,263.515,16,4,10,10,12,76,1.031,1,16,4,12,0,-12
"DG_s11",97,264.515,265.125,266.562,266.578,13,1,10,10,12,82,1.437,1,13,1,12,0,-12
"DG_s11",98,267.578,268.187,269.687,269.687,10,10,11,7,0,82,1.5,0,11,7,4,0,-4
"DG_s11",99,270.703,271.312,272.578,272.578,10,10,6,11,0,82,1.266,0,6,11,5,5,0
"DG_s11",100,273.578,274.187,276.078,276.093,10,10,15,30,0,82,1.891,0,15,30,15,15,0
"DG_s11",101,277.093,277.703,279.093,279.109,18,10,10,10,8,76,1.39,1,18,10,8,0,-8
"DG_s11",102,280.109,280.718,281.953,281.953,10,10,6,14,0,76,1.235,0,6,14,8,8,0
"DG_s11",103,282.953,283.562,285.047,285.047,10,10,10,22,0,76,1.485,0,10,22,12,12,0
"DG_s11",104,286.062,286.672,287.968,287.968,30,10,10,10,20,82,1.296,1,30,10,20,0,-20
"DG_s11",105,288.968,289.578,290.75,290.765,18,12,10,10,6,76,1.172,1,18,12,6,0,-6
"DG_s11",106,291.765,292.375,293.453,293.468,18,10,10,10,8,76,1.078,1,18,10,8,0,-8
"DG_s11",107,294.468,295.078,296.297,296.297,13,1,10,10,12,82,1.219,1,13,1,12,0,-12
"DG_s11",108,297.297,297.906,299.297,299.297,16,8,10,10,8,76,1.391,1,16,8,8,0,-8
"DG_s11",109,300.297,300.906,302.047,302.047,26,10,10,10,16,76,1.141,1,26,10,16,0,-16
"DG_s11",110,303.062,303.672,304.812,304.828,22,13,10,10,9,82,1.14,1,22,13,9,0,-9
"DG_s11",111,305.828,306.437,307.703,307.703,10,10,8,16,0,76,1.266,0,8,16,8,8,0
"DG_s11",112,308.718,309.328,311.047,311.047,10,10,12,18,0,82,1.719,0,12,18,6,6,0
"DG_s11",113,312.062,312.672,313.797,313.812,10,10,12,4,0,82,1.125,0,12,4,8,0,-8
"DG_s11",114,314.812,315.422,316.64,316.64,10,10,14,26,0,82,1.218,0,14,26,12,12,0
"DG_s11",115,317.64,318.25,319.625,319.625,10,10,10,30,0,76,1.375,0,10,30,20,20,0
"DG_s11",116,320.625,321.234,323.015,323.015,14,14,10,10,0,82,1.781,1,14,14,0,0,0
"DG_s11",117,324.031,324.64,325.765,325.765,10,10,6,14,0,76,1.125,0,6,14,8,8,0
"DG_s11",118,326.781,327.39,328.468,328.484,10,10,6,11,0,76,1.078,0,6,11,5,5,0
"DG_s11",119,329.484,330.093,331.093,331.093,30,15,10,10,15,76,1,1,30,15,15,0,-15
"DG_s11",120,332.093,332.703,333.781,333.797,10,10,3,17,0,76,1.078,0,3,17,14,14,0
"DG_s11",121,334.797,335.406,336.765,336.765,13,7,10,10,6,76,1.359,1,13,7,6,0,-6
"DG_s11",122,337.765,338.375,339.734,339.734,10,10,12,18,0,76,1.359,0,12,18,6,6,0
"DG_s11",123,340.734,341.343,342.843,342.843,16,8,10,10,8,76,1.5,1,16,8,8,0,-8
"DG_s11",124,343.843,344.453,345.718,345.718,10,10,10,30,0,76,1.265,0,10,30,20,20,0
"DG_s11",125,346.734,347.343,348.515,348.515,18,12,10,10,6,76,1.172,1,18,12,6,0,-6
"DG_s11",126,349.515,350.125,351.484,351.484,10,10,2,2,0,76,1.359,0,2,2,0,0,0
"DG_s11",127,352.484,353.093,354.281,354.281,10,10,3,31,0,76,1.188,0,3,31,28,28,0
"DG_s11",128,355.281,355.89,357.765,357.781,10,10,10,22,0,82,1.875,0,10,22,12,12,0
"DG_s11",129,358.781,359.39,360.64,360.64,26,10,10,10,16,82,1.25,1,26,10,16,0,-16
"DG_s11",130,361.64,362.25,363.297,363.297,30,10,10,10,20,76,1.047,1,30,10,20,0,-20
"DG_s11",131,364.297,364.906,366.125,366.14,10,10,6,22,0,82,1.219,0,6,22,16,16,0
"DG_s11",132,367.14,367.75,369.547,369.562,10,10,10,18,0,76,1.797,0,10,18,8,8,0
"DG_s11",133,370.562,371.172,372.531,372.531,10,10,13,22,0,82,1.359,0,13,22,9,9,0
"DG_s11",134,373.531,374.14,375.468,375.484,10,10,3,31,0,76,1.328,0,3,31,28,28,0
"DG_s11",135,376.484,377.093,378.328,378.328,26,14,10,10,12,82,1.235,1,26,14,12,0,-12
"DG_s11",136,379.328,379.937,380.968,380.968,18,2,10,10,16,82,1.031,1,18,2,16,0,-16
"DG_s11",137,381.968,382.578,384.218,384.218,16,16,10,10,0,76,1.64,1,16,16,0,0,0
"DG_s11",138,385.218,385.828,387.234,387.234,10,10,8,11,0,76,1.406,0,8,11,3,3,0
"DG_s11",139,388.234,388.843,390.343,390.343,10,10,10,26,0,76,1.5,0,10,26,16,16,0
"DG_s11",140,391.343,391.953,393.25,393.25,10,10,15,30,0,82,1.297,0,15,30,15,15,0
"DG_s11",141,394.25,394.859,396.578,396.593,22,10,10,10,12,76,1.719,1,22,10,12,0,-12
"DG_s11",142,397.593,398.203,399.468,399.484,12,4,10,10,8,76,1.265,1,12,4,8,0,-8
"DG_s11",143,400.484,401.093,402.343,402.343,26,14,10,10,12,82,1.25,1,26,14,12,0,-12
"DG_s11",144,403.343,403.953,405.39,405.39,22,6,10,10,16,76,1.437,1,22,6,16,0,-16
"DG_s11",145,406.406,407.015,408.281,408.281,10,10,6,22,0,82,1.266,0,6,22,16,16,0
"DG_s11",146,409.281,409.89,411.093,411.093,10,10,8,12,0,76,1.203,0,8,12,4,4,0
"DG_s11",147,412.109,412.718,413.656,413.656,10,10,3,12,0,82,0.938,0,3,12,9,9,0
"DG_s11",148,414.656,415.265,416.656,416.656,18,2,10,10,16,76,1.391,1,18,2,16,0,-16
"DG_s11",149,417.656,418.265,419.312,419.312,22,10,10,10,12,82,1.047,1,22,10,12,0,-12
"DG_s11",150,420.312,420.922,422.218,422.234,22,13,10,10,9,76,1.296,1,22,13,9,0,-9
"DG_s11",151,423.234,423.843,425.187,425.187,10,10,8,12,0,76,1.344,0,8,12,4,4,0
"DG_s11",152,426.187,426.797,428.015,428.015,10,10,3,12,0,76,1.218,0,3,12,9,9,0
"DG_s11",153,429.015,429.625,431.031,431.031,10,10,10,18,0,76,1.406,0,10,18,8,8,0
"DG_s11",154,432.031,432.64,433.75,433.75,12,12,10,10,0,76,1.11,1,12,12,0,0,0
"DG_s11",155,434.75,435.359,436.39,436.39,10,10,8,8,0,76,1.031,0,8,8,0,0,0
"DG_s11",156,437.39,438,438.812,438.828,28,4,10,10,24,76,0.812,1,28,4,24,0,-24
"DG_s11",157,439.828,440.437,441.515,441.515,22,6,10,10,16,82,1.078,1,22,6,16,0,-16
"DG_s11",158,442.515,443.125,444.125,444.14,30,15,10,10,15,76,1,1,30,15,15,0,-15
"DG_s11",159,445.14,445.75,446.906,446.906,28,4,10,10,24,76,1.156,1,28,4,24,0,-24
"DG_s11",160,447.906,448.515,449.484,449.5,10,10,4,4,0,76,0.969,0,4,4,0,0,0
"DG_s11",161,450.5,451.109,452.484,452.5,13,7,10,10,6,76,1.375,1,13,7,6,0,-6
"DG_s11",162,453.5,454.109,455.875,455.89,10,10,10,26,0,76,1.766,0,10,26,16,16,0
"DG_s11",163,456.89,457.5,458.984,458.984,10,10,13,22,0,76,1.484,0,13,22,9,9,0
"DG_s11",164,459.984,460.593,462.265,462.265,16,4,10,10,12,76,1.672,1,16,4,12,0,-12
"DG_s11",165,463.265,463.875,464.906,464.922,10,10,8,11,0,76,1.031,0,8,11,3,3,0
"DG_s11",166,465.922,466.531,467.672,467.672,18,18,10,10,0,76,1.141,1,18,18,0,0,0
"DG_s11",167,468.672,469.281,470.531,470.531,10,10,8,16,0,82,1.25,0,8,16,8,8,0
"DG_s11",168,471.531,472.14,473.187,473.203,10,10,3,17,0,76,1.047,0,3,17,14,14,0
"DG_s11",169,474.203,474.812,475.75,475.75,10,10,6,6,0,76,0.938,0,6,6,0,0,0
"DG_s11",170,476.75,477.359,478.672,478.672,10,10,14,26,0,76,1.313,0,14,26,12,12,0
"DG_s11",171,479.672,480.281,481.812,481.828,11,7,10,10,4,76,1.531,1,11,7,4,0,-4
"DG_s11",172,482.828,483.437,484.812,484.828,16,4,10,10,12,76,1.375,1,16,4,12,0,-12
"DG_s11",173,485.828,486.437,487.812,487.812,13,1,10,10,12,82,1.375,1,13,1,12,0,-12
"DG_s11",174,488.812,489.422,490.797,490.797,11,7,10,10,4,76,1.375,1,11,7,4,0,-4
"DG_s11",175,491.797,492.406,493.39,493.39,10,10,6,11,0,82,0.984,0,6,11,5,5,0
"DG_s11",176,494.406,495.015,497.078,497.078,10,10,15,30,0,82,2.063,0,15,30,15,15,0
"DG_s11",177,498.078,498.687,500.406,500.406,18,10,10,10,8,76,1.719,1,18,10,8,0,-8
"DG_s11",178,501.422,502.031,503.203,503.203,10,10,6,14,0,76,1.172,0,6,14,8,8,0
"DG_s11",179,504.203,504.812,506.312,506.312,10,10,10,22,0,76,1.5,0,10,22,12,12,0
"DG_s11",180,507.312,507.922,509.437,509.437,30,10,10,10,20,82,1.515,1,30,10,20,0,-20
"DG_s11",181,510.453,511.062,512.484,512.484,18,12,10,10,6,76,1.422,1,18,12,6,0,-6
"DG_s11",182,513.484,514.093,515.562,515.562,18,10,10,10,8,76,1.469,1,18,10,8,0,-8
"DG_s11",183,516.562,517.172,518.906,518.906,13,1,10,10,12,82,1.734,1,13,1,12,0,-12
"DG_s11",184,519.906,520.515,522.109,522.109,16,8,10,10,8,76,1.594,1,16,8,8,0,-8
"DG_s11",185,523.109,523.718,524.812,524.828,26,10,10,10,16,76,1.094,1,26,10,16,0,-16
"DG_s11",186,525.828,526.437,527.547,527.547,22,13,10,10,9,82,1.11,1,22,13,9,0,-9
"DG_s11",187,528.547,529.156,530.453,530.453,10,10,8,16,0,76,1.297,0,8,16,8,8,0
"DG_s11",188,531.453,532.062,533.593,533.593,10,10,12,18,0,82,1.531,0,12,18,6,6,0
"DG_s11",189,534.593,535.203,536.859,536.859,12,4,10,10,8,76,1.656,1,12,4,8,0,-8
"DG_s11",190,537.859,538.468,539.812,539.812,10,10,14,26,0,82,1.344,0,14,26,12,12,0
"DG_s11",191,540.812,541.422,542.687,542.687,10,10,10,30,0,76,1.265,0,10,30,20,20,0
"DG_s11",192,543.687,544.297,546.078,546.078,14,14,10,10,0,82,1.781,1,14,14,0,0,0
"DG_s11",193,547.078,547.687,549.031,549.031,10,10,6,14,0,76,1.344,0,6,14,8,8,0
"DG_s11",194,550.031,550.64,552.515,552.531,10,10,6,11,0,76,1.875,0,6,11,5,5,0
"DG_s11",195,553.531,554.14,555.547,555.547,30,15,10,10,15,76,1.407,1,30,15,15,0,-15
"DG_s11",196,556.547,557.156,558.437,558.437,10,10,3,17,0,76,1.281,0,3,17,14,14,0
"DG_s11",197,559.437,560.047,561.687,561.687,13,7,10,10,6,76,1.64,1,13,7,6,0,-6
"DG_s11",198,562.687,563.297,564.828,564.828,10,10,12,18,0,76,1.531,0,12,18,6,6,0
"DG_s11",199,565.828,566.437,567.984,567.984,16,8,10,10,8,76,1.547,1,16,8,8,0,-8
"DG_s11",200,568.984,569.593,571.015,571.015,10,10,10,30,0,76,1.422,0,10,30,20,20,0
"DG_s11",201,572.015,572.625,574.14,574.14,18,12,10,10,6,76,1.515,1,18,12,6,0,-6
"DG_s11",202,575.156,575.765,577.218,577.234,10,10,2,2,0,76,1.453,0,2,2,0,0,0
"DG_s11",203,578.234,578.843,580.156,580.156,10,10,3,31,0,76,1.313,0,3,31,28,28,0
"DG_s11",204,581.156,581.765,583.562,583.578,10,10,10,22,0,82,1.797,0,10,22,12,12,0
"DG_s11",205,584.578,585.187,586.437,586.437,26,10,10,10,16,82,1.25,1,26,10,16,0,-16
"DG_s11",206,587.453,588.062,589.234,589.25,30,10,10,10,20,76,1.172,1,30,10,20,0,-20
"DG_s11",207,590.25,590.859,592.14,592.14,10,10,6,22,0,82,1.281,0,6,22,16,16,0
"DG_s11",208,593.156,593.765,595.203,595.203,10,10,10,18,0,76,1.438,0,10,18,8,8,0
"DG_s11",209,596.203,596.812,598.125,598.125,10,10,13,22,0,82,1.313,0,13,22,9,9,0
"DG_s11",210,599.125,599.734,600.984,600.984,10,10,3,31,0,76,1.25,0,3,31,28,28,0
"DG_s11",211,601.984,602.593,603.75,603.75,26,14,10,10,12,82,1.157,1,26,14,12,0,-12
"DG_s11",212,604.765,605.375,606.64,606.656,18,2,10,10,16,82,1.265,1,18,2,16,0,-16
"DG_s11",213,607.656,608.265,609.672,609.672,16,16,10,10,0,76,1.407,1,16,16,0,0,0
"DG_s11",214,610.672,611.281,612.375,612.375,10,10,8,11,0,76,1.094,0,8,11,3,3,0
"DG_s11",215,613.375,613.984,615.375,615.375,10,10,10,26,0,76,1.391,0,10,26,16,16,0
"DG_s11",216,616.375,616.984,618.359,618.359,10,10,15,30,0,82,1.375,0,15,30,15,15,0
"DG_s11",217,619.359,619.968,621.625,621.625,22,10,10,10,12,76,1.657,1,22,10,12,0,-12
"DG_s11",218,622.625,623.234,624.859,624.875,12,4,10,10,8,76,1.625,1,12,4,8,0,-8
"DG_s11",219,625.875,626.484,627.703,627.703,26,14,10,10,12,82,1.219,1,26,14,12,0,-12
"DG_s11",220,628.703,629.312,630.843,630.843,22,6,10,10,16,76,1.531,1,22,6,16,0,-16
"DG_s11",221,631.843,632.453,634.328,634.328,10,10,6,22,0,82,1.875,0,6,22,16,16,0
"DG_s11",222,635.328,635.937,637.125,637.125,10,10,8,12,0,76,1.188,0,8,12,4,4,0
"DG_s11",223,638.14,638.75,639.843,639.859,10,10,3,12,0,82,1.093,0,3,12,9,9,0
"DG_s11",224,640.859,641.468,642.906,642.906,18,2,10,10,16,76,1.438,1,18,2,16,0,-16
"DG_s11",225,643.906,644.515,645.703,645.703,22,10,10,10,12,82,1.188,1,22,10,12,0,-12
"DG_s11",226,646.703,647.312,648.656,648.672,22,13,10,10,9,76,1.344,1,22,13,9,0,-9
"DG_s11",227,649.672,650.281,651.5,651.5,10,10,8,12,0,76,1.219,0,8,12,4,4,0
"DG_s11",228,652.5,653.109,654.343,654.343,10,10,3,12,0,76,1.234,0,3,12,9,9,0
"DG_s12",1,-0.703,0,0.75,0.75,10,18,10,10,8,82,0.75,1,10,18,8,8,0
"DG_s12",2,1.75,2.453,3.375,3.375,12,12,10,10,0,76,0.922,1,12,12,0,0,0
"DG_s12",3,4.375,5.078,5.969,5.984,10,10,8,8,0,76,0.891,0,8,8,0,0,0
"DG_s12",4,6.984,7.687,8.406,8.406,28,4,10,10,24,76,0.719,1,28,4,24,0,-24
"DG_s12",5,9.406,10.109,10.765,10.765,22,6,10,10,16,82,0.656,1,22,6,16,0,-16
"DG_s12",6,11.765,12.469,13.094,13.094,30,15,10,10,15,76,0.625,1,30,15,15,0,-15
"DG_s12",7,14.094,14.797,15.453,15.453,28,4,10,10,24,76,0.656,1,28,4,24,0,-24
"DG_s12",8,16.453,17.156,18.64,18.656,10,10,4,4,0,76,1.484,0,4,4,0,0,0
"DG_s12",9,19.656,20.359,21.859,21.859,13,7,10,10,6,76,1.5,1,13,7,6,0,-6
"DG_s12",10,22.859,23.562,24.25,24.25,10,26,10,10,16,82,0.688,1,10,26,16,16,0
"DG_s12",11,25.25,25.953,26.859,26.859,13,22,10,10,9,82,0.906,1,13,22,9,9,0
"DG_s12",12,27.859,28.562,29.469,29.469,16,4,10,10,12,76,0.907,1,16,4,12,0,-12
"DG_s12",13,30.469,31.172,32.14,32.14,10,10,8,11,0,76,0.968,0,8,11,3,3,0
"DG_s12",14,33.14,33.844,34.422,34.422,18,18,10,10,0,76,0.578,1,18,18,0,0,0
"DG_s12",15,35.422,36.125,36.812,36.812,10,10,8,16,0,82,0.687,0,8,16,8,8,0
"DG_s12",16,37.812,38.515,39.719,39.734,10,10,3,17,0,76,1.204,0,3,17,14,14,0
"DG_s12",17,40.734,41.437,42.219,42.219,10,10,6,6,0,76,0.782,0,6,6,0,0,0
"DG_s12",18,43.219,43.922,44.578,44.594,14,26,10,10,12,82,0.656,1,14,26,12,12,0
"DG_s12",19,45.594,46.297,47.14,47.14,11,7,10,10,4,76,0.843,1,11,7,4,0,-4
"DG_s12",20,48.14,48.844,49.64,49.656,16,4,10,10,12,76,0.796,1,16,4,12,0,-12
"DG_s12",21,50.656,51.359,52.234,52.234,13,1,10,10,12,82,0.875,1,13,1,12,0,-12
"DG_s12",22,53.234,53.937,54.765,54.765,11,7,10,10,4,76,0.828,1,11,7,4,0,-4
"DG_s12",23,55.765,56.469,57.484,57.484,6,11,10,10,5,76,1.015,1,6,11,5,5,0
"DG_s12",24,58.484,59.187,59.906,59.906,15,30,10,10,15,76,0.719,1,15,30,15,15,0
"DG_s12",25,60.922,61.625,62.531,62.531,18,10,10,10,8,76,0.906,1,18,10,8,0,-8
"DG_s12",26,63.547,64.25,64.953,64.953,6,14,10,10,8,82,0.703,1,6,14,8,8,0
"DG_s12",27,65.953,66.656,67.375,67.39,10,22,10,10,12,82,0.719,1,10,22,12,12,0
"DG_s12",28,68.39,69.094,69.797,69.797,30,10,10,10,20,82,0.703,1,30,10,20,0,-20
"DG_s12",29,70.797,71.5,72.047,72.062,18,12,10,10,6,76,0.547,1,18,12,6,0,-6
"DG_s12",30,73.062,73.765,74.328,74.344,18,10,10,10,8,76,0.563,1,18,10,8,0,-8
"DG_s12",31,75.344,76.047,76.734,76.75,13,1,10,10,12,82,0.687,1,13,1,12,0,-12
"DG_s12",32,77.75,78.453,79.234,79.234,16,8,10,10,8,76,0.781,1,16,8,8,0,-8
"DG_s12",33,80.25,80.953,81.484,81.484,26,10,10,10,16,76,0.531,1,26,10,16,0,-16
"DG_s12",34,82.484,83.187,83.812,83.812,22,13,10,10,9,82,0.625,1,22,13,9,0,-9
"DG_s12",35,84.812,85.515,86.234,86.234,10,10,8,16,0,76,0.719,0,8,16,8,8,0
"DG_s12",36,87.25,87.953,88.875,88.875,12,18,10,10,6,76,0.922,1,12,18,6,6,0
"DG_s12",37,89.89,90.594,91.25,91.25,10,10,12,4,0,82,0.656,0,12,4,8,0,-8
"DG_s12",38,92.25,92.953,93.484,93.484,14,26,10,10,12,76,0.531,1,14,26,12,12,0
"DG_s12",39,94.484,95.187,95.844,95.844,10,30,10,10,20,82,0.657,1,10,30,20,20,0
"DG_s12",40,96.859,97.562,98.515,98.515,14,14,10,10,0,82,0.953,1,14,14,0,0,0
"DG_s12",41,99.531,100.234,100.906,100.906,10,10,6,14,0,76,0.672,0,6,14,8,8,0
"DG_s12",42,101.922,102.625,103.469,103.469,10,10,6,11,0,76,0.844,0,6,11,5,5,0
"DG_s12",43,104.469,105.172,105.828,105.828,30,15,10,10,15,76,0.656,1,30,15,15,0,-15
"DG_s12",44,106.828,107.531,108.203,108.203,10,10,3,17,0,76,0.672,0,3,17,14,14,0
"DG_s12",45,109.203,109.906,110.765,110.781,10,10,13,7,0,82,0.859,0,13,7,6,0,-6
"DG_s12",46,111.781,112.484,113.25,113.25,10,10,12,18,0,76,0.766,0,12,18,6,6,0
"DG_s12",47,114.265,114.969,115.625,115.625,16,8,10,10,8,76,0.656,1,16,8,8,0,-8
"DG_s12",48,116.625,117.328,118.015,118.031,10,30,10,10,20,82,0.687,1,10,30,20,20,0
"DG_s12",49,119.031,119.734,120.328,120.328,18,12,10,10,6,76,0.594,1,18,12,6,0,-6
"DG_s12",50,121.328,122.031,122.547,122.547,10,10,2,2,0,76,0.516,0,2,2,0,0,0
"DG_s12",51,123.562,124.265,124.812,124.812,10,10,3,31,0,76,0.547,0,3,31,28,28,0
"DG_s12",52,125.812,126.515,127.422,127.437,10,22,10,10,12,76,0.907,1,10,22,12,12,0
"DG_s12",53,128.437,129.14,129.734,129.734,26,10,10,10,16,82,0.594,1,26,10,16,0,-16
"DG_s12",54,130.734,131.437,131.984,131.984,30,10,10,10,20,76,0.547,1,30,10,20,0,-20
"DG_s12",55,132.984,133.687,134.531,134.531,10,10,6,22,0,82,0.844,0,6,22,16,16,0
"DG_s12",56,135.531,136.234,136.859,136.859,10,10,10,18,0,76,0.625,0,10,18,8,8,0
"DG_s12",57,137.875,138.578,139.703,139.703,13,22,10,10,9,76,1.125,1,13,22,9,9,0
"DG_s12",58,140.703,141.406,142.203,142.203,3,31,10,10,28,82,0.797,1,3,31,28,28,0
"DG_s12",59,143.203,143.906,144.719,144.719,26,14,10,10,12,82,0.813,1,26,14,12,0,-12
"DG_s12",60,145.719,146.422,147.25,147.25,18,2,10,10,16,82,0.828,1,18,2,16,0,-16
"DG_s12",61,148.265,148.969,149.562,149.562,16,16,10,10,0,76,0.593,1,16,16,0,0,0
"DG_s12",62,150.562,151.265,152.281,152.297,10,10,8,11,0,76,1.016,0,8,11,3,3,0
"DG_s12",63,153.297,154,154.765,154.781,10,26,10,10,16,82,0.765,1,10,26,16,16,0
"DG_s12",64,155.781,156.484,157.031,157.031,15,30,10,10,15,76,0.547,1,15,30,15,15,0
"DG_s12",65,158.031,158.734,159.281,159.281,22,10,10,10,12,76,0.547,1,22,10,12,0,-12
"DG_s12",66,160.281,160.984,161.594,161.594,12,4,10,10,8,76,0.61,1,12,4,8,0,-8
"DG_s12",67,162.594,163.297,163.937,163.937,26,14,10,10,12,82,0.64,1,26,14,12,0,-12
"DG_s12",68,164.937,165.64,166.219,166.219,22,6,10,10,16,76,0.579,1,22,6,16,0,-16
"DG_s12",69,167.234,167.937,168.594,168.594,6,22,10,10,16,76,0.657,1,6,22,16,16,0
"DG_s12",70,169.609,170.312,170.875,170.875,10,10,8,12,0,76,0.563,0,8,12,4,4,0
"DG_s12",71,171.875,172.578,173.14,173.14,10,10,3,12,0,82,0.562,0,3,12,9,9,0
"DG_s12",72,174.14,174.844,175.406,175.406,18,2,10,10,16,76,0.562,1,18,2,16,0,-16
"DG_s12",73,176.406,177.109,177.687,177.687,22,10,10,10,12,82,0.578,1,22,10,12,0,-12
"DG_s12",74,178.687,179.39,179.844,179.844,22,13,10,10,9,76,0.454,1,22,13,9,0,-9
"DG_s12",75,180.844,181.547,182.234,182.234,10,10,8,12,0,76,0.687,0,8,12,4,4,0
"DG_s12",76,183.234,183.937,184.531,184.531,10,10,3,12,0,76,0.594,0,3,12,9,9,0
"DG_s12",77,185.531,186.234,186.812,186.812,10,10,10,18,0,76,0.578,0,10,18,8,8,0
"DG_s12",78,187.812,188.515,189.187,189.187,12,12,10,10,0,76,0.672,1,12,12,0,0,0
"DG_s12",79,190.187,190.89,191.578,191.578,10,10,8,8,0,76,0.688,0,8,8,0,0,0
"DG_s12",80,192.578,193.281,194,194.015,28,4,10,10,24,76,0.719,1,28,4,24,0,-24
"DG_s12",81,195.015,195.719,196.39,196.406,10,10,22,6,0,76,0.671,0,22,6,16,0,-16
"DG_s12",82,197.406,198.109,198.75,198.75,30,15,10,10,15,76,0.641,1,30,15,15,0,-15
"DG_s12",83,199.75,200.453,201.265,201.265,28,4,10,10,24,76,0.812,1,28,4,24,0,-24
"DG_s12",84,202.281,202.984,203.781,203.781,10,10,4,4,0,76,0.797,0,4,4,0,0,0
"DG_s12",85,204.781,205.484,206.375,206.375,13,7,10,10,6,76,0.891,1,13,7,6,0,-6
"DG_s12",86,207.375,208.078,208.859,208.859,10,26,10,10,16,82,0.781,1,10,26,16,16,0
"DG_s12",87,209.859,210.562,211.219,211.219,13,22,10,10,9,82,0.657,1,13,22,9,9,0
"DG_s12",88,212.234,212.937,213.89,213.89,16,4,10,10,12,76,0.953,1,16,4,12,0,-12
"DG_s12",89,214.89,215.594,216.39,216.39,8,11,10,10,3,82,0.796,1,8,11,3,3,0
"DG_s12",90,217.39,218.094,218.781,218.797,18,18,10,10,0,76,0.687,1,18,18,0,0,0
"DG_s12",91,219.797,220.5,221.156,221.156,8,16,10,10,8,76,0.656,1,8,16,8,8,0
"DG_s12",92,222.156,222.859,223.422,223.437,10,10,3,17,0,76,0.563,0,3,17,14,14,0
"DG_s12",93,224.437,225.14,225.734,225.75,10,10,6,6,0,76,0.594,0,6,6,0,0,0
"DG_s12",94,226.75,227.453,228.234,228.234,14,26,10,10,12,82,0.781,1,14,26,12,12,0
"DG_s12",95,229.25,229.953,230.687,230.687,11,7,10,10,4,76,0.734,1,11,7,4,0,-4
"DG_s12",96,231.687,232.39,233.047,233.062,16,4,10,10,12,76,0.657,1,16,4,12,0,-12
"DG_s12",97,234.062,234.765,235.703,235.719,10,10,13,1,0,76,0.938,0,13,1,12,0,-12
"DG_s12",98,236.719,237.422,238.328,238.328,10,10,11,7,0,82,0.906,0,11,7,4,0,-4
"DG_s12",99,239.328,240.031,241.015,241.015,10,10,6,11,0,82,0.984,0,6,11,5,5,0
"DG_s12",100,242.015,242.719,243.484,243.484,15,30,10,10,15,76,0.765,1,15,30,15,15,0
"DG_s12",101,244.484,245.187,245.922,245.922,18,10,10,10,8,76,0.735,1,18,10,8,0,-8
"DG_s12",102,246.937,247.64,248.375,248.375,10,10,6,14,0,76,0.735,0,6,14,8,8,0
"DG_s12",103,249.375,250.078,250.984,251,10,10,10,22,0,76,0.906,0,10,22,12,12,0
"DG_s12",104,252,252.703,253.484,253.484,30,10,10,10,20,82,0.781,1,30,10,20,0,-20
"DG_s12",105,254.484,255.187,255.828,255.828,18,12,10,10,6,76,0.641,1,18,12,6,0,-6
"DG_s12",106,256.828,257.531,258.156,258.156,18,10,10,10,8,76,0.625,1,18,10,8,0,-8
"DG_s12",107,259.156,259.859,260.484,260.484,10,10,13,1,0,76,0.625,0,13,1,12,0,-12
"DG_s12",108,261.484,262.187,262.781,262.781,16,8,10,10,8,76,0.594,1,16,8,8,0,-8
"DG_s12",109,263.781,264.484,265.094,265.094,26,10,10,10,16,76,0.61,1,26,10,16,0,-16
"DG_s12",110,266.094,266.797,267.453,267.469,22,13,10,10,9,82,0.656,1,22,13,9,0,-9
"DG_s12",111,268.469,269.172,269.812,269.812,10,10,8,16,0,76,0.64,0,8,16,8,8,0
"DG_s12",112,270.812,271.515,272.125,272.125,12,18,10,10,6,76,0.61,1,12,18,6,6,0
"DG_s12",113,273.125,273.828,274.859,274.859,12,4,10,10,8,76,1.031,1,12,4,8,0,-8
"DG_s12",114,275.859,276.562,277.281,277.281,14,26,10,10,12,76,0.719,1,14,26,12,12,0
"DG_s12",115,278.297,279,279.672,279.687,10,30,10,10,20,82,0.672,1,10,30,20,20,0
"DG_s12",116,280.687,281.39,282,282,10,10,14,14,0,76,0.61,0,14,14,0,0,0
"DG_s12",117,283,283.703,284.312,284.328,10,10,6,14,0,76,0.609,0,6,14,8,8,0
"DG_s12",118,285.328,286.031,286.875,286.875,10,10,6,11,0,76,0.844,0,6,11,5,5,0
"DG_s12",119,287.875,288.578,289.297,289.297,30,15,10,10,15,76,0.719,1,30,15,15,0,-15
"DG_s12",120,290.312,291.015,292.047,292.047,10,10,3,17,0,76,1.032,0,3,17,14,14,0
"DG_s12",121,293.047,293.75,294.89,294.89,13,7,10,10,6,76,1.14,1,13,7,6,0,-6
"DG_s12",122,295.89,296.594,297.422,297.437,12,18,10,10,6,82,0.828,1,12,18,6,6,0
"DG_s12",123,298.437,299.14,299.812,299.812,16,8,10,10,8,76,0.672,1,16,8,8,0,-8
"DG_s12",124,300.812,301.515,302.703,302.703,10,10,10,30,0,76,1.188,0,10,30,20,20,0
"DG_s12",125,303.703,304.406,305.344,305.344,18,12,10,10,6,76,0.938,1,18,12,6,0,-6
"DG_s12",126,306.344,307.047,307.75,307.75,10,10,2,2,0,76,0.703,0,2,2,0,0,0
"DG_s12",127,308.75,309.453,310.422,310.437,3,31,10,10,28,82,0.969,1,3,31,28,28,0
"DG_s12",128,311.437,312.14,313.015,313.015,10,22,10,10,12,76,0.875,1,10,22,12,12,0
"DG_s12",129,314.015,314.719,315.672,315.672,26,10,10,10,16,82,0.953,1,26,10,16,0,-16
"DG_s12",130,316.672,317.375,318.062,318.062,30,10,10,10,20,76,0.687,1,30,10,20,0,-20
"DG_s12",131,319.062,319.765,320.515,320.515,10,10,6,22,0,82,0.75,0,6,22,16,16,0
"DG_s12",132,321.515,322.219,323.344,323.359,10,18,10,10,8,82,1.125,1,10,18,8,8,0
"DG_s12",133,324.359,325.062,326.015,326.015,13,22,10,10,9,76,0.953,1,13,22,9,9,0
"DG_s12",134,327.015,327.719,328.969,328.969,10,10,3,31,0,76,1.25,0,3,31,28,28,0
"DG_s12",135,329.984,330.687,331.5,331.5,26,14,10,10,12,82,0.813,1,26,14,12,0,-12
"DG_s12",136,332.5,333.203,334.015,334.015,18,2,10,10,16,82,0.812,1,18,2,16,0,-16
"DG_s12",137,335.015,335.719,336.547,336.547,16,16,10,10,0,76,0.828,1,16,16,0,0,0
"DG_s12",138,337.547,338.25,339.437,339.437,10,10,8,11,0,76,1.187,0,8,11,3,3,0
"DG_s12",139,340.437,341.14,342.047,342.062,10,26,10,10,16,82,0.907,1,10,26,16,16,0
"DG_s12",140,343.062,343.765,344.469,344.484,15,30,10,10,15,76,0.704,1,15,30,15,15,0
"DG_s12",141,345.484,346.187,347.062,347.078,22,10,10,10,12,76,0.875,1,22,10,12,0,-12
"DG_s12",142,348.078,348.781,349.672,349.672,12,4,10,10,8,76,0.891,1,12,4,8,0,-8
"DG_s12",143,350.687,351.39,352.125,352.125,26,14,10,10,12,82,0.735,1,26,14,12,0,-12
"DG_s12",144,353.125,353.828,354.39,354.39,22,6,10,10,16,76,0.562,1,22,6,16,0,-16
"DG_s12",145,355.39,356.094,357.062,357.078,10,10,6,22,0,82,0.968,0,6,22,16,16,0
"DG_s12",146,358.078,358.781,359.515,359.515,8,12,10,10,4,82,0.734,1,8,12,4,4,0
"DG_s12",147,360.515,361.219,361.984,361.984,10,10,3,12,0,82,0.765,0,3,12,9,9,0
"DG_s12",148,363,363.703,364.265,364.265,18,2,10,10,16,76,0.562,1,18,2,16,0,-16
"DG_s12",149,365.265,365.969,366.578,366.578,22,10,10,10,12,82,0.609,1,22,10,12,0,-12
"DG_s12",150,367.578,368.281,368.844,368.859,22,13,10,10,9,76,0.563,1,22,13,9,0,-9
"DG_s12",151,369.859,370.562,371.578,371.578,10,10,8,12,0,76,1.016,0,8,12,4,4,0
"DG_s12",152,372.578,373.281,373.969,373.969,10,10,3,12,0,76,0.688,0,3,12,9,9,0
"DG_s12",153,374.969,375.672,376.531,376.531,10,10,10,18,0,76,0.859,0,10,18,8,8,0
"DG_s12",154,377.531,378.234,379.547,379.547,12,12,10,10,0,76,1.313,1,12,12,0,0,0
"DG_s12",155,380.547,381.25,382.328,382.328,10,10,8,8,0,76,1.078,0,8,8,0,0,0
"DG_s12",156,383.344,384.047,385,385,28,4,10,10,24,76,0.953,1,28,4,24,0,-24
"DG_s12",157,386.015,386.719,387.484,387.484,22,6,10,10,16,82,0.765,1,22,6,16,0,-16
"DG_s12",158,388.484,389.187,389.922,389.922,30,15,10,10,15,76,0.735,1,30,15,15,0,-15
"DG_s12",159,390.922,391.625,392.797,392.812,28,4,10,10,24,76,1.172,1,28,4,24,0,-24
"DG_s12",160,393.812,394.515,395.406,395.422,10,10,4,4,0,76,0.891,0,4,4,0,0,0
"DG_s12",161,396.422,397.125,398.203,398.203,13,7,10,10,6,76,1.078,1,13,7,6,0,-6
"DG_s12",162,399.203,399.906,400.656,400.656,10,26,10,10,16,82,0.75,1,10,26,16,16,0
"DG_s12",163,401.656,402.359,403.281,403.281,13,22,10,10,9,82,0.922,1,13,22,9,9,0
"DG_s12",164,404.281,404.984,405.906,405.906,16,4,10,10,12,76,0.922,1,16,4,12,0,-12
"DG_s12",165,406.906,407.609,408.297,408.297,10,10,8,11,0,76,0.688,0,8,11,3,3,0
"DG_s12",166,409.297,410,410.765,410.765,18,18,10,10,0,76,0.765,1,18,18,0,0,0
"DG_s12",167,411.765,412.469,413.515,413.515,10,10,8,16,0,82,1.046,0,8,16,8,8,0
"DG_s12",168,414.515,415.219,415.969,415.969,10,10,3,17,0,76,0.75,0,3,17,14,14,0
"DG_s12",169,416.969,417.672,418.422,418.422,10,10,6,6,0,76,0.75,0,6,6,0,0,0
"DG_s12",170,419.422,420.125,420.922,420.922,14,26,10,10,12,82,0.797,1,14,26,12,12,0
"DG_s12",171,421.922,422.625,423.937,423.937,11,7,10,10,4,76,1.312,1,11,7,4,0,-4
"DG_s12",172,424.937,425.64,426.562,426.562,16,4,10,10,12,76,0.922,1,16,4,12,0,-12
"DG_s12",173,427.562,428.265,429.39,429.39,13,1,10,10,12,82,1.125,1,13,1,12,0,-12
"DG_s12",174,430.39,431.094,432.031,432.047,11,7,10,10,4,76,0.937,1,11,7,4,0,-4
"DG_s12",175,433.047,433.75,434.859,434.859,10,10,6,11,0,82,1.109,0,6,11,5,5,0
"DG_s12",176,435.859,436.562,437.609,437.609,15,30,10,10,15,76,1.047,1,15,30,15,15,0
"DG_s12",177,438.625,439.328,440.406,440.406,18,10,10,10,8,76,1.078,1,18,10,8,0,-8
"DG_s12",178,441.406,442.109,442.906,442.906,10,10,6,14,0,76,0.797,0,6,14,8,8,0
"DG_s12",179,443.906,444.609,445.812,445.828,10,10,10,22,0,76,1.203,0,10,22,12,12,0
"DG_s12",180,446.828,447.531,448.437,448.453,30,10,10,10,20,82,0.906,1,30,10,20,0,-20
"DG_s12",181,449.453,450.156,450.969,450.969,18,12,10,10,6,76,0.813,1,18,12,6,0,-6
"DG_s12",182,451.984,452.687,453.515,453.515,18,10,10,10,8,76,0.828,1,18,10,8,0,-8
"DG_s12",183,454.515,455.219,456.328,456.328,10,10,13,1,0,76,1.109,0,13,1,12,0,-12
"DG_s12",184,457.328,458.031,458.922,458.922,16,8,10,10,8,76,0.891,1,16,8,8,0,-8
"DG_s12",185,459.922,460.625,461.453,461.469,26,10,10,10,16,76,0.828,1,26,10,16,0,-16
"DG_s12",186,462.469,463.172,464.094,464.109,22,13,10,10,9,82,0.922,1,22,13,9,0,-9
"DG_s12",187,465.109,465.812,467.312,467.312,10,10,8,16,0,76,1.5,0,8,16,8,8,0
"DG_s12",188,468.312,469.015,470.031,470.031,12,18,10,10,6,76,1.016,1,12,18,6,6,0
"DG_s12",189,471.031,471.734,473.14,473.156,12,4,10,10,8,76,1.406,1,12,4,8,0,-8
"DG_s12",190,474.156,474.859,475.984,475.984,14,26,10,10,12,76,1.125,1,14,26,12,12,0
"DG_s12",191,477,477.703,479.172,479.172,10,30,10,10,20,82,1.469,1,10,30,20,20,0
"DG_s12",192,480.172,480.875,481.875,481.875,14,14,10,10,0,82,1,1,14,14,0,0,0
"DG_s12",193,482.875,483.578,485.39,485.39,10,10,6,14,0,76,1.812,0,6,14,8,8,0
"DG_s12",194,486.39,487.094,488.234,488.234,10,10,6,11,0,76,1.14,0,6,11,5,5,0
"DG_s12",195,489.234,489.937,490.703,490.703,30,15,10,10,15,76,0.766,1,30,15,15,0,-15
"DG_s12",196,491.703,492.406,493.594,493.594,10,10,3,17,0,76,1.188,0,3,17,14,14,0
"DG_s12",197,494.594,495.297,496.078,496.094,13,7,10,10,6,76,0.781,1,13,7,6,0,-6
"DG_s12",198,497.094,497.797,498.937,498.937,12,18,10,10,6,82,1.14,1,12,18,6,6,0
"DG_s12",199,499.937,500.64,501.453,501.469,16,8,10,10,8,76,0.813,1,16,8,8,0,-8
"DG_s12",200,502.469,503.172,504.437,504.453,10,30,10,10,20,82,1.265,1,10,30,20,20,0
"DG_s12",201,505.453,506.156,507.422,507.422,18,12,10,10,6,76,1.266,1,18,12,6,0,-6
"DG_s12",202,508.422,509.125,509.906,509.906,10,10,2,2,0,76,0.781,0,2,2,0,0,0
"DG_s12",203,510.906,511.609,512.75,512.765,10,10,3,31,0,76,1.141,0,3,31,28,28,0
"DG_s12",204,513.765,514.469,515.672,515.672,10,22,10,10,12,76,1.203,1,10,22,12,12,0
"DG_s12",205,516.687,517.39,518.437,518.437,26,10,10,10,16,82,1.047,1,26,10,16,0,-16
"DG_s12",206,519.437,520.14,520.906,520.906,30,10,10,10,20,76,0.766,1,30,10,20,0,-20
"DG_s12",207,521.906,522.609,523.422,523.437,10,10,6,22,0,82,0.813,0,6,22,16,16,0
"DG_s12",208,524.437,525.14,526.375,526.375,10,18,10,10,8,82,1.235,1,10,18,8,8,0
"DG_s12",209,527.375,528.078,528.89,528.89,13,22,10,10,9,76,0.812,1,13,22,9,9,0
"DG_s12",210,529.89,530.594,531.703,531.703,10,10,3,31,0,76,1.109,0,3,31,28,28,0
"DG_s12",211,532.703,533.406,534.219,534.219,26,14,10,10,12,82,0.813,1,26,14,12,0,-12
"DG_s12",212,535.219,535.922,537.14,537.14,10,10,18,2,0,76,1.218,0,18,2,16,0,-16
"DG_s12",213,538.14,538.844,539.719,539.719,16,16,10,10,0,76,0.875,1,16,16,0,0,0
"DG_s12",214,540.719,541.422,542.5,542.515,10,10,8,11,0,76,1.078,0,8,11,3,3,0
"DG_s12",215,543.515,544.219,545.281,545.281,10,26,10,10,16,82,1.062,1,10,26,16,16,0
"DG_s12",216,546.281,546.984,547.75,547.765,15,30,10,10,15,76,0.766,1,15,30,15,15,0
"DG_s12",217,548.765,549.469,550.14,550.14,22,10,10,10,12,76,0.671,1,22,10,12,0,-12
"DG_s12",218,551.14,551.844,552.75,552.75,12,4,10,10,8,76,0.906,1,12,4,8,0,-8
"DG_s12",219,553.75,554.453,555.094,555.109,26,14,10,10,12,82,0.641,1,26,14,12,0,-12
"DG_s12",220,556.109,556.812,557.469,557.469,22,6,10,10,16,76,0.657,1,22,6,16,0,-16
"DG_s12",221,558.469,559.172,560.312,560.312,6,22,10,10,16,76,1.14,1,6,22,16,16,0
"DG_s12",222,561.312,562.015,562.828,562.844,10,10,8,12,0,76,0.813,0,8,12,4,4,0
"DG_s12",223,563.844,564.547,565.328,565.328,10,10,3,12,0,82,0.781,0,3,12,9,9,0
"DG_s12",224,566.344,567.047,567.656,567.656,18,2,10,10,16,76,0.609,1,18,2,16,0,-16
"DG_s12",225,568.656,569.359,570.031,570.031,22,10,10,10,12,82,0.672,1,22,10,12,0,-12
"DG_s12",226,571.031,571.734,572.312,572.312,22,13,10,10,9,76,0.578,1,22,13,9,0,-9
"DG_s12",227,573.328,574.031,574.781,574.797,10,10,8,12,0,76,0.75,0,8,12,4,4,0
"DG_s12",228,575.797,576.5,577.359,577.359,10,10,3,12,0,76,0.859,0,3,12,9,9,0
